A long time ago, there lived a king who had only one eye and one leg	Dahulu kala, hidup seorang raja yang hanya memiliki satu mata dan satu kaki
One day, as the king strolled through the royal gallery he saw the paintings of his predecessors	Suatu hari, saat raja berjalan-jalan di galeri kerajaan ia melihat lukisan-lukisan pendahulunya
The king then summoned all the painters in his country to the palace	Raja lalu memanggil semua pelukis yang ada di negerinya ke istana
He asked for a beautiful painting and looked dashing to be displayed in the palace gallery	Ia meminta untuk dibuatkan lukisan yang indah dan terlihat gagah untuk dipajang di galeri istana
Painters who dare to accept this task will be rewarded according to the beauty of the painting	Pelukis yang berani menerima tugas ini akan diberi imbalan sesuai dengan keindahan lukisannya
The painters began to think after hearing the king's command, they thought it was impossible to make a beautiful painting	Para pelukis mulai berpikir setelah mendengar titah raja, menurut mereka tidak mungkin bisa membuat lukisan yang indah
The painters resigned one by one for various reasons	Pelukis-pelukis itu pun satu per satu mengundurkan diri dengan berbagai alasan
They fear that if the result is bad, they will be punished for insulting the king.	Mereka takut jika nanti hasilnya buruk, mereka malah diberi hukuman karena dianggap menghina raja
Then, one of the painters volunteered to paint the deformed king	Lalu, salah seorang pelukis mengajukan diri untuk melukis raja yang cacat tersebut
For weeks the painter worked on the painting the king had asked for	Berminggu-minggu si pelukis mengerjakan lukisan yang diminta raja
Until finally came the day when the painting was exhibited to the public	Sampai akhirnya tiba hari saat lukisan itu dipamerkan kepada publik
The painters who resigned came to the palace, they saw the beautiful painting	Para pelukis yang mengundurkan diri datang ke istana, mereka melihat lukisan indah itu
The painters' assumptions disappeared immediately when the cover cloth of the painting was opened	Anggapan para pelukis itu langsung sirna ketika kain penutup lukisan itu dibuka
Because, the result of the painting is very beautiful and the king looks dashing	Sebab, hasil lukisan itu sangatlah indah dan sang raja terlihat gagah
In the painting the king is pictured riding a horse facing sideways	Di lukisan raja digambarkan sedang menunggangi kuda yang menghadap ke samping
While preparing to shoot. So that his deformed legs are invisible	Sambil bersiap memanah. Sehingga kakinya yang cacat tidak terlihat
The king was very satisfied with the painting, he earned a castle for the painter	Raja sangat puas dengan hasil lukisan tersebut, ia menghadiahi sebuah kastil untuk si pelukis
Recently, Steve had a car accident. Because the car has to be repaired in the workshop	Baru-baru ini, Steve mengalami kecelakaan mobil. Karena mobilnya harus diperbaiki di bengkel
He gave a little money to the old beggar.	Ia memberikan sedikit uang pada pengemis tua itu
The next day he found the beggar again. This time, Steve took the beggar to lunch together	Keesokan harinya ia menemukan pengemis itu lagi. Kali ini, Steve mengajak pengemis itu untuk makan siang bersama
It's just that I'm sad when the people I helped used to won't help me.	Hanya saja aku sedih ketika orang-orang yang kubantu dulu tidak mau membantuku
It's better to invite troubled people to your home, than to share bricks when you build your own house	Lebih baik mengundang orang kesusahan ke rumahmu, daripada membagikan bata saat kamu membangun rumahmu sendiri
Once Sidharta Gautama traveled to visit several cities with his students	Suatu ketika Sidharta Gautama melakukan perjalanan mengunjungi beberapa kota bersama muridnya
Shortly before entering the first city, he rested under a shady tree	Sesaat sebelum memasuki kota pertama, ia beristirahat di bawah sebuah pohon yang rindang
Around where they rested, there was a small lake	Di sekitar tempat mereka beristirahat itu, ada sebuah danau kecil
Sidharta Gautama then asked his students to take water to drink from the lake	Sidharta Gautama kemudian meminta muridnya mengambil air untuk minum dari danau tersebut
At that time in the lake there were many people who washed their clothes while playing in the water	Saat itu di danau sedang banyak warga yang mencuci pakaian sambil bermain di air
When the student returned to the lake, no one had washed their clothes	Ketika si murid kembali ke danau, sudah tidak ada orang yang mencuci pakaian
The lake water is clear because the dirt has settled to the bottom of the lake	Air danau pun sudah jernih karena kotorannya telah mengendap ke dasar danau
The student took the water and delivered it to his teacher	Si murid itu pun mengambil air dan mengantarkannya pada gurunya
Sidharta Gautama then said, 'The murky water in the lake is like the human mind when stressed'	Sidharta Gautama lalu berkata, ‘Air keruh di danau seperti pikiran manusia ketika stres'
Meanwhile, clear water is like the human mind when calm	Sementara, air yang jernih seperti pikiran manusia ketika tenang
Sometimes the best way to clear your mind is to be patient	Terkadang jalan terbaik untuk menjernihkan pikiran adalah dengan bersabar
In a village located on the banks of the river, there is a temple that is often visited by residents	Di sebuah desa yang terletak di tepian sungai, terdapat sebuah kuil yang sering dikunjungi warga
The temple is run by a very devout pastor	Kuil tersebut diurus oleh seorang pendeta yang sangat taat beribadah
One day during the transition of the season, heavy rains caused the river to overflow	Suatu hari pada peralihan musim, turun hujan deras yang menyebabkan sungai meluap
Slowly but surely, the water began to enter people's homes to the height of their feet	Perlahan tapi pasti, air mulai memasuki rumah warga hingga setinggi mata kaki
Most of the residents then evacuated while carrying valuables	Sebagian besar warga kemudian mengungsikan diri sambil membawa barang berharga
One of the displaced residents warned the priest who was still praying at the temple to leave the village immediately	Salah satu warga yang mengungsi memperingatkan pendeta yang masih berdoa di kuil untuk segera pergi dari desa
The remaining residents pulled out rubber boats and rescued themselves	Warga yang tersisa mengeluarkan perahu karet dan menyelamatkan diri
The rain is still continuing, this time the water level has reached the waist	Hujan masih berlanjut, kali ini ketinggian air sudah mencapai pinggang
Some residents inspected the temple and found the priest sitting on his table	Beberapa warga memeriksa kuil dan menemukan pendeta duduk di atas mejanya
They forced him to board the boat, but the priest refused to leave for the same reason	Mereka memaksanya naik ke perahu, namun pendeta itu tetap menolak untuk pergi dengan alasan yang sama
The devout priest continued to pray in his room. But the rain hasn't shown any signs of stopping.	Pendeta yang taat itu terus berdoa di ruangannya. Tapi hujan yang turun belum menunjukkan tanda-tanda akan berhenti
The priest still refuses to evacuate. He was convinced that God would save him.	Pendeta itu masih menolak untuk mengungsi. Ia yakin bahwa Tuhan akan menyelamatkannya
Moments later, a SAR team helicopter came and picked him up	Beberapa saat kemudian, helikopter tim SAR datang dan menjemputnya
Due to the increasingly dangerous circumstances, the helicopter left	Karena keadaan yang semakin berbahaya, helikopter pun meninggalkanya
An hour has passed since the helicopter came to the pastor, the rain is still heavy	Satu jam berlalu sejak helikopter tadi mendatangi pendeta, hujan masih deras
He began to panic and said, 'Lord, I have always been obedient to you	Ia mulai panik dan berkata, ‘Tuhan, aku sudah selalu taat menyembahmu
I believe you're going to save me. But why do you let me suffer like this?	Aku percaya engkau kan menyelamatkanku. Tapi mengapa kau biarkan aku menderita terus begini?
Today princess's 14th birthday.Usually on the princess's birthday, mom will cook her favorite food	Hari ini Putri berulang tahun yang ke 14. Biasanya di hari ulang tahun Putri, ibu akan memasak makanan kesukaannya
But that day it turned out that The Princess's sister was sick, so the mother bothered to take care of her sick son	Tapi hari itu ternyata adik Putri sedang sakit, sehingga ibu repot merawat anaknya yang sakit
As soon as the school bell rang, Putri immediately rushed home	Begitu bel pulang sekolah berbunyi, Putri langsung bergegas pulang
The princess was upset with her parents for feeling unnoticed. He then went from home to the garden	Putri kesal pada orangtuanya karena merasa tidak diperhatikan. Ia lalu pergi dari rumah menuju ke taman
At that time there were only meatballs around who sell in the park	Saat itu hanya ada tukang bakso keliling yang berjualan di taman
The princess approached the meatball man, unfortunately she had no money	Putri pun mendekati tukang bakso itu, sayangnya ia tak memiliki uang
Seeing Putri's face, the meatball man offered her a free bowl of meatballs	Melihat wajah Putri yang memelas, tukang bakso itu menawarinya semangkuk bakso gratis
While eating that bowl of meatballs, suddenly the princess's tears were dripping	Sambil memakan semangkuk bakso itu, tiba-tiba air mata putri menetes
It's actually my birthday, I'm moved, my new brother is very nice.	Sebenarnya ini hari ulang tahunku, aku terharu, abang yang baru kenal malah baik sekali
The princess listened to the meatball seller's advice and went home. Arriving home, he apologized to his mother	Putri pun mendengarkan nasihat penjual bakso itu dan pulang. Sampai di rumah, ia meminta maaf pada ibunya
In a shopping mall there was a little girl selling roses	Di sebuah pusat perbelanjaan ada seorang anak perempuan kecil yang menjual bunga mawar
The boy used to sell there from morning until afternoon	Anak itu biasa berjualan di sana dari pagi hari hingga sore
One afternoon while passing through the shopping mall, the little boy approached me	Suatu siang saat melewati pusat perbelanjaan, anak kecil itu mendekatiku
I saw in the basket the boy was still left about twenty sprigs of roses	Sempat kulihat di keranjang anak itu masih tersisa sekitar dua puluh tangkai mawar
In the afternoon I went through the shopping center again and saw the little boy still offering his flowers	Sore harinya aku lewat pusat perbelanjaan itu lagi dan melihat si anak kecil masih menawarkan bunganya
He offered me another flower, apparently forgetting this afternoon had offered me flowers	Ia menawarkan bunga lagi padaku, tampaknya lupa siang tadi telah menawarkan bunga
I see the basket is still about fourteen sprigs of roses.	Kulihat keranjangnya masih sekitar empat belas tangkai mawar
I feel sorry for him but because I still have business and don't need flowers	Aku kasihan dengannya tapi karena aku masih memiliki urusan dan tidak membutuhkan bunga
I subtly rejected it and I gave the boy a five thousand	kutolak dengan halus lalu kuberi anak itu selembar uang lima ribu
The boy took my money and gave it to a beggar nearby.	Anak itu mengambil uangku lalu memberikannya pada seorang pengemis di dekat sana
an old carpenter who has worked for decades began to feel if his body was getting old	seorang tukang kayu tua yang sudah bekerja puluhan tahun mulai merasa jika tubuhnya sudah semakin tua
He then prepares to talk to his foreman about plans to retire	Ia lalu mempersiapkan diri untuk berbicara dengan mandornya tentang rencana untuk pensiun
Hearing the retirement plan, the foreman becomes sad	Mendengar rencana pensiun itu, sang mandor menjadi sedih
Because, the carpenter who wants to retire is the best carpenter	Sebab, tukang kayu yang hendak pensiun itu merupakan tukang kayu terbaiknya
Foreman then allowed his carpenter to retire after completing one more project	Mandor lalu mengizinkan tukang kayunya pensiun setelah menyelesaikan satu proyek lagi
A few weeks later, came a new project to make the house	Beberapa minggu kemudian, datang sebuah proyek baru untuk membuat rumah
Old carpenter who wants to retire is handed over as in charge	Tukang kayu tua yang hendak pensiun dipasrahi sebagai penanggung jawab
he was given the freedom to make the building as he pleases.	ia diberi kebebasan membuat bangunan itu sesuka hatinya
After learning his last project was a house, the handyman became irritated	Setelah tahu proyek terakhirnya adalah sebuah rumah, tukang itu menjadi jengkel
Because, the house takes a long time to finish	Sebab, rumah memakan waktu yang cukup lama untuk selesai
He also worked lazy and made a home with origins	Ia pun bekerja malas-malasan dan membuat rumah dengan asal-asalan
The materials used were not studied for quality	Bahan-bahan yang digunakan pun tidak diteliti kualitasnya
This house you built is a gift from me for you. Thank you for working well	Rumah yang kau bangun ini adalah hadiah dariku untukmu. Terima kasih telah bekerja dengan baik
A 24 year old man was on the train with his father	Seorang lelaki berusia 24 tahun sedang berada di kereta api bersama dengan ayahnya
He looked out through the train window and shouted, "Dad, look at the trees walking!"	Ia melihat keluar melalui jendela kereta api dan berteriak, “Ayah, lihat pohon-pohon itu berjalan!”
His father smiled, but the young couple sat nearby	Ayahnya tersenyum, namun pasangan muda yang duduk di dekatnya
Looking at the childish behavior of a 24 year old man with pity	Memandang perilaku kekanak-kanakan lelaki yang berusia 24 tahun dengan kasihan
I've taken him to the doctor, and we just got home from the hospital.	Saya sudah membawanya ke dokter, dan kami baru saja pulang dari Rumah Sakit
My son was blind from birth, he was only able to get an eye donor and could only see today	Anak saya buta sejak lahir, dia baru bisa mendapatkan donor mata dan baru bisa melihat hari ini
Don't judge others before you actually know them	Jangan menilai orang lain sebelum anda benar-benar mengenal mereka
Because the reality may surprise you	Karena kenyataannya yang terjadi mungkin dapat mengejutkan anda
A man's favorite donkey falls into a deep hole	Keledai favorit seorang pria jatuh ke dalam sebuah lubang yang dalam
Search and Rescue team in charge of evacuating and rescuing victims	tim Search and Rescue yang bertugas mengevakuasi dan menyelamatkan korban
survivors and volunteers from various regions also helped	masyarakat yang selamat serta para relawan dari berbagai wilayah pun turut membantu
When the focus on saving victims ends, we will enter the next stage, namely the reconstruction and rehabilitation stage.	Ketika fokus pada penyelamatan korban berakhir, maka kita akan memasuki tahapan berikutnya, yaitu tahapan rekonstruksi dan rehabilitasi.
When a disaster occurs, roads will be damaged, houses will be damaged, and some will even be destroyed	Ketika bencana terjadi,jalan-jalan akan rusak, rumah-rumah rusak, bahkan ada yang hancur
Often natural disasters also claim lives, people are left homeless, markets are closed, economic activity is disrupted,	Seringkali bencana alam juga menelan korban jiwa, orang-orang kehilangan tempat tinggal, pasar tutup, aktivitas ekonomi terganggu,
All of this is very possible for many victims to experience psychological disorders, such as prolonged trauma.	Semua itu sangat memungkinkan banyak korban yang mengalami gangguan psikologis, seperti trauma yang berkepanjangan.
All stages of repair are called the reconstruction and rehabilitation stages.	Semua tahapan memperbaiki itu semua disebut tahapan rekonstruksi dan rehabilitasi.
Houses began to be built, as well as streets, and various other buildings. Markets that were closed are slowly reopening.	Rumah-rumah mulai di bangun, begitu pula jalan-jalan, serta berbagai bangunan lainnya. Pasar yang tutup perlahan dibuka kembali. 
just returning to the beginning won't be enough, they have to prepare themselves for the disasters that will come again.	kembali seperti awal aja nggak akan cukup, mereka harus mempersiapkan diri untuk menghadapi bencana yang akan kembali datang.
To deal with upcoming disasters, all parties, both the community and the government, learn from previous events	Untuk menghadapi bencana yang akan datang, seluruh pihak, baik masyarakat maupun pemerintah belajar dari kejadian sebelumnya
Various actions aimed at minimizing casualties have started to be taken	Berbagai tindakan yang tujuannya untuk meminimalisir korban jiwa mulai dilakukan
Such as building earthquake-proof houses, or creating evacuation routes or routes,	Seperti membuat rumah anti gempa, atau membuat rute atau jalur evakuasi,
The government and the disaster team, can also conduct outreach and outreach on disaster management to the community,	Pemerintah dan tim kebencanaan, juga bisa melakukan sosialisasi dan penyuluhan tentang penanggulangan bencana kepada masyarakat,
There are three causes of water pollution. There are pollutants from industrial waste, household waste, and agricultural waste.	ada tiga penyebab pencemaran air Ada polutan dari limbah industri, limbah rumah tangga, dan limbah pertanian.
Wastewater from industrial processing tends to contain hazardous substances	Air limbah dari hasil pengolahan industri ini cenderung mengandung zat berbahaya
Usually the industry from textile factories or paper mills becomes the most pollutant	Biasanya industri dari pabrik tekstil atau pabrik kertas yang paling banyak menjadi polutan
waste steel factories, paint factories, and pharmaceutical plants. Waste of this type is in the form of foam, contains sulfuric acid, with a strong odor.	limbah pabrik baja, pabrik cat, dan pabrik farmasi. Limbah dari jenis ini berupa busa, mengandung asam belerang, dengan bau yang menyengat. 
household waste originates from the results of housing activities such as households, markets, offices, restaurants,	limbah rumah tangga asalnya dari hasil kegiatan perumahan seperti rumah tangga, pasar, perkantoran, rumah makan,
Household waste is divided into organic, inorganic and other hazardous materials	Limbah rumah tangga terbagi atas bahan organik, anorganik, dan bahan berbahaya lainnya
Organic waste includes fruit peels, vegetables, food scraps, leaves, and so on.	Limbah organik itu misalnya kulit buah, sayuran, sisa makanan, daun, dan sebagainya. 
Inorganic wastes include aluminum, plastics, glass, beverage cans and oil.	Limbah anorganik itu contohnya aluminium, plastik, kaca, kaleng minuman, dan minyak.
The agricultural sector is a factor causing waste, namely the use of fertilizers and chemicals.	sektor pertanian ini adalah faktor penyebab limbah, yakni penggunaan pupuk dan bahan kimia. 
The impact of water pollution decreases the quality of the environment, causes health problems, is concentrated in biology, and disturbs the beauty of the area	Dampak Pencemaran Air penurunan kualitas lingkungan, gangguan kesehatan, pemekatan hayati, dan  mengganggu keindahan wilayah
In this stabilization pond, the wastewater is treated naturally. This is done to neutralize pollutants before they are discharged into the river.	Di kolam stabilisasi ini air limbah diolah secara alami. Ini dilakukan untuk menetralisasi zat-zat pencemar sebelum dialirkan ke sungai.
Wastewater treatment using special equipment is divided into three stages, namely primary treatment, secondary treatment, and tertiary treatment	Pengolahan air limbah menggunakan alat khusus dibagi tiga tahapan, yakni primary treatment , secondary treatment , dan tertiary treatment
Excrexta Management (Human Excreta). This management can be found in septic tanks which can be processed anaerobically into biogas	Pengelolaan Excrexta (Human Excreta). Pengelolaan ini dapat ditemukan dalam septic tank yangbisa diolah dengan cara anaerobik menjadi biogas
Air pollution is an air condition containing large amounts of chemical and biological compounds	Pencemaran udara itu suatu kondisi udara mengandung senyawa kimia maupun biologi dalam jumlah banyak 
In general, pollution is divided into two, namely primary air pollution and secondary air pollution	Secara umum, pencemaran terbagi menjadi dua, yakni pencemaran udara primer dan pencemaran udara sekunder
This primary air pollution causes directly from pollutants, such as increased levels of carbon dioxide from human combustion activities.	Pencemaran udara primer ini penyebabnya langsung dari polutan, seperti meningkatnya kadar karbondioksida dari aktivitas pembakaran manusia.
Secondary air pollution occurs due to chemical reactions of pollutant particles that occur in the atmosphere, such as the formation of ozone.	pencemaran udara sekunder itu terjadi akibat reaksi kimia dari partikel-partikel polutan yang terjadi di atmosfer, seperti pembentukan ozon.
The causes of air pollution are divided into two, namely natural activities and human activities.	penyebab pencemaran udara itu terbagi menjadi dua, yakni aktivitas alam dan aktivitas manusia. 
forest fires that produce large amounts of carbon dioxide. Can interfere with human and animal health	kebakaran lahan hutan yang menghasilkan karbon dioksida dalam jumlah yang banyak. Bisa mengganggu kesehatan manusia dan hewan
human activity air pollution, such as factory smoke, motor vehicle fumes, burning garbage and cigarette smoke	polusi udara aktivitas manusia itu , seperti asap pabrik, asap kendaraan bermotor, pembakaran sampah dan asap rokok
Decreased air quality due to this pollution causes various diseases, especially respiratory diseases	Kualitas udara yang menurun akibat pencemaran ini menimbulkan berbagai penyakit, terutama penyakit pernafasan
Volcanic eruptions that cause volcanic ash also pollute the air and cause acid rain.	Letusan gunung berapi yang menimbulkan abu vulkanik juga membuat udara tercemar dan mengakibatkan hujan asam.
This acid rain contains sulfur which interferes with the growth of surrounding plants	Hujan asam ini mengandung sulfur yang mengganggu pertumbuhan tanaman di sekitarnya
The emergence of the greenhouse effect, namely an increase in Earth's temperature due to high concentrations of carbon dioxide and carbon monoxide in the atmosphere	Timbulnya efek rumah kaca yakni peningkatan suhu bumi karena konsentrasi karbon dioksida dan karbon monoksida yang tinggi di atmosfer
The use of air conditioning products that contain CFCs such as freezers and air conditioners can damage the ozone layer.	Penggunaan produk pendingin ruangan yang mengandung CFC seperti freezer dan AC dapat merusak lapisan ozon.
If the burden of your life is always compared to others then believe me that it will all get heavier	Jika beban hidupmu selalu dibandingkan dengan orang lain maka percayalah bahwa semua itu akan semakin berat
What Andi has been thinking about other people is not all right	Yang selama ini dipikirkan Andi tentang orang lain tidak semuanya benar
But he himself does not know very well how other people's condition	Padahal dia sendiri tidak tahu betul bagaimana kondisi orang lain
which he thinks is always okay could be the opposite	yang menurutnya selalu baik-baik saja bisa jadi kebalikannya
It could have been that they had made it through the toughest times of their lives	Bisa saja mereka telah berhasil melalui masa-masa terberat dalam hidupnya
He just fell silent in my words. He thought about what I was saying at the time.	dia hanya terdiam merenungi perkataanku. Dia memikirkan apa yang aku katakan saat itu
Although sometimes advising others is not as easy as advising yourself	Meskipun terkadang menasehati orang lain tidak semudah menasehati diri sendiri
Sometimes I still like to compare myself to other people.	Terkadang aku sendiri masih suka membanding- bandingkan diri dengan orang lain
I've also felt like I'm in Andi's current position.	Waktu dulu aku juga pernah merasakan seperti di posisi Andi saat ini
At that time there was also someone who advised me that God always gives the burden of problems according to the ability of each person	Saat itu juga ada yang menasehati aku bahwa Tuhan selalu memberikan beban masalah sesuai dengan kemampuan masing-masing orang
Therefore the response from people is also different, sometimes some feel burdened there are also those who do not	Oleh karena itu respon dari orang-orang pun juga berbeda-beda, terkadang ada yang merasa dibebani ada juga yang tidak
God knows how strong we are to be able to deal with the problems given by Him	Tuhan tahu seberapa kuat kita untuk bisa menghadapi masalah yang diberikan oleh-Nya
Therefore if the question of portion should not be asked yes, because we know that God is indeed Just	Maka dari itu kalau soal porsi jangan ditanyakan ya, karena kita tahu kalau Tuhan itu memang Maha Adil
From then on I began to introspect myself. I'm trying to solve all the problems.	Mulai saat itu aku mulai introspeksi perihal diriku sendiri. Aku berusaha untuk menyelesaikan segala permasalahan
Solve all the problems that befall me with a spacious heart. Because that way I can be happy	Menyelesaikan segala permasalahan yang menimpaku dengan hati yang lapang. Karena dengan begitu aku bisa menjadi bahagia
I also don't have to compare myself to anyone else	Aku juga tidak perlu membandingkan diriku dengan orang lain
I just need to compare myself to the one I was yesterday.	Aku hanya perlu membandingkan diriku dengan aku yang kemarin
That's why I can be a better person to date.	Maka dari itu aku bisa menjadi pribadi yang lebih baik hingga saat ini
I also believe that every problem that befalls me can be a lesson in my life.	Aku juga percaya jika setiap masalah yang menimpaku nantinya bisa menjadi pelajaran dalam hidupku
Because there's always wisdom I can take from every one of my joys and sorrows.	Karena selalu ada hikmah yang bisa aku ambil dari setiap suka dan duka ku
In recent days, the school has been busy discussing the feast of sacrifice	Beberapa hari ini, sekolah sedang ramai perbincangan hari raya kurban
Ustazah said, the feast of sacrifice is the feast of Muslims	Kata Ustazah, hari raya kurban adalah hari rayanya umat Islam
The feast of sacrifice is the feast of the slaughter of goats. I'm happy on the feast of sacrifice	Hari raya kurban adalah hari raya pemotongan kambing. Aku senang saat hari raya kurban
There's a lot of friends at school. Because during the feast of sacrifice, many events in our school are fun	Ada banyak sekali kawan-kawan di sekolah. Karena saat hari raya kurban, banyak peristiwa di sekolah kami yang menyenangkan
We crowded into the farm to buy goats. In the farm there are a lot of goats	Kami ramai-ramai ke penternakan untuk membeli kambing. Di penternakan ada banyak sekali macam kambing
The goats eat grass and have four legs	Kambing-kambing makan rumput dan mempunyai kaki empat
The goats also went to school and the next day were ready for slaughter	Kambing-kambing juga ikut ke sekolah dan keesokan harinya siap disembelih
I saw goats being slaughtered. There's a lot of blood and smell.	Aku melihat kambing yang disembelih. Ada banyak darahnya dan bau
Mutton is separated from its skin. Then wrapped and handed out to people	Daging kambing dipisahkan dari kulitnya. Kemudian dibungkus dan dibagi-bagikan ke orang-orang
Me and my friends shared some mutton. I also met a new friend, her name is Naya	Aku dan teman-teman ikut membagikan daging kambing. Aku juga ketemu teman baru, namanya Naya
Since receiving meat from me and taking it home to cook with her grandmother, Naya has been grateful	Sejak menerima daging dariku dan dibawanya pulang untuk dimasak bersama neneknya, Naya jadi berterima kasih
Since then, Naya has always been kind. He even helped when he fell.	Sejak saat itu, Naya jadi selalu baik hati. Bahkan ia menolong saat terjatuh
Naya is very happy because she has not eaten satay for a long time	Naya senang sekali karena sudah lama tidak makan sate
If I had the meat processed into soup. I love making me soup.	Kalau aku dagingnya diolah jadi sup. Ibu suka sekali membuatkan aku sup
During Eid al-Fitr, Naya came to my house and ate soup together	Saat hari raya idul kurban, Naya ikut ke rumahku dan makan sup bersama
In a school, there is a child named Arkhan.Arkhan is a large kindergarten class and often makes the teacher angry	Di suatu sekolah, ada anak bernama Arkhan. Arkhan adalah anak kelas TK besar dan sering membuat Bu guru marah
Because it often makes the teacher angry, Arkhan is often called but not scolded	Karena sering membuat Bu guru marah, Arkhan sering dipanggil tetapi tidak dimarahi
Arkhan often apologizes for his mistakes. She also often makes friends cry	Arkhan sering meminta maaf atas kesalahannya. Dia juga sering membuat teman-teman menangis
Some items were also taken by Arkhan.Arkhan is also famous for often fuzzy	Beberapa barang juga diambil oleh Arkhan. Arkhan juga terkenal sering kabur-kaburan
On his way home from school, Arkhan had not been picked up by his mother	Pada suatu hari saat pulang sekolah, Arkhan belum dijemput oleh ibunya
If you haven't been picked up, you can't go home yet. However, Arkhan often ran and hid	Kalau belum dijemput, maka belum boleh pulang. Tetapi, Arkhan sering berlari dan bersembunyi
Arkhan avoids the teacher and always travels around the spacious schoolyard	Arkhan menghindari Bu guru dan selalu berkeliling halaman sekolah yang luas
As usual, the teacher searched for Arkhan to every corner of the room	Seperti biasanya, Bu guru mencari Arkhan ke setiap sudut ruangan
As soon as the teacher got there, Arkhan wasn't there. There have been several places visited, but there is still no sign of Arkhan	Begitu Bu guru kesana, Arkhan tidak ada. Sudah beberapa tempat dikunjungi, tapi tetap tidak ada tanda-tanda keberadaan Arkhan
The fresh atmosphere of the wind that came out in the fan made The Teacher not realize that Arkhan was there	Suasana segar dari angin yang keluar di kipas membuat Bu Guru tidak menyadari kalau Arkhan ada di sana
After that, Arkhan and the teacher went to the pickup lounge and Arkhan played some puzzles	Setelah itu, Arkhan dan Ibu guru pun ke ruang tunggu penjemputan dan Arkhan bermain beberapa puzzle
Arkhan loves to play puzzles especially humaira's panda puzzles	Arkhan sangat suka bermain puzzle terlebih puzzle panda milik Humaira
Humaira who is used to tidy up the toys. However, there is one that is	Humaira yang terbiasa rapi pun membereskan mainannya. Namun, ada satu yang mengganjal
Humaira started pacing around, and soon she was sad.	Humaira mulai mondar-mandir ke sana kemari, lalu tidak lama kemudian ia sedih
In the end, everyone in the room looked for Humaira's puzzle with a picture of a panda.	Pun pada akhirnya semua yang ada di ruangan mencari puzzlenya Humaira yang bergambar panda
There's only one possibility, it could be that the puzzle came arkhan home.	Hanya ada satu kemungkinan, bisa jadi puzzle itu ikut Arkhan pulang
Finally Arkhan returns Humaira's puzzle that has started to stop crying	Akhirnya Arkhan mengembalikan puzzle milik Humaira yang sudah mulai berhenti menangis
Arkhan often brings home things at school that he finds interesting	Arkhan sering membawa pulang benda-benda di sekolah yang menurutnya menarik
Even in the past he once carried a mic cable obtained from a school office closet	Bahkan tempo lalu ia pernah membawa kabel mic yang didapat dari lemari kantor sekolah
After the incident that day, the next day Arkhan always said when he wanted to borrow goods	Setelah kejadian di hari itu, keesokan harinya Arkhan pun selalu bilang saat hendak meminjam barang
That way, Arkhan became a lot of friends	Dengan begitu, Arkhan pun jadi punya banyak teman
Now friends are no longer afraid when hanging out with Arkhan	Sekarang teman-teman sudah tidak takut lagi saat bergaul dengan Arkhan
Unlike in the old days, there must have been many who were afraid to be close to Arkhan because Arkhan was famously naughty	Berbeda pada saat dulu, pasti banyak yang takut dekat dengan Arkhan karena Arkhan terkenal nakal
They also tend to stay away in order to avoid losing their belongings because they were stolen by Arkhan	Mereka juga cenderung menjauh supaya bisa menghindari barang-barangnya hilang karena dicuri oleh Arkhan
In the end all the friends became willing to hang out and join Arkhan	Pada akhirnya semua teman-teman jadi mau bergaul dan bergabung dengan Arkhan
Basically a child's story using a simple style of language	Pada dasarnya cerita anak menggunakan gaya bahasa yang sederhana
The maximum length limit of short stories is 20 pages or no more than 10,000 words	Batas panjang maksimal cerpen adalah 20 halaman atau tidak lebih dari 10.000 kata
The essence of the story based on the short story contains only one main problem	Inti dari kisah yang diangkat pada cerpen hanya memuat satu permasalahan utama saja
The morning before when a girl commonly called dara started pouring water to make a glass of hot tea	Pagi menjelang saat seorang gadis yang biasa dipanggil dengan nama Dara mulai menjerang air untuk membuat segelas teh panas
Dara, is a girl who lives with a million dreams in a high-walled house	Dara, ialah gadis yang hidup dengan sejuta mimpi di dalam sebuah rumah berdinding tinggi
Dara is a girl who grows up in a well-off family	Dara merupakan gadis yang tumbuh di dalam keluarga berkecukupan
Every day Dara spends only time in the room and occasionally directs her wheelchair towards the garden	Setiap hari Dara hanya menghabiskan waktunya di dalam kamar dan sesekali mengarahkan kursi rodanya menuju arah taman
The 17 year old girl was thrilled to draw in the park to dispel her bad thoughts	Gadis yang berusia 17 tahun tersebut sangat senang untuk menggambar di taman guna menghilangkan pikiran buruknya
One morning Dara fell out of her wheelchair, but no one was in the house	Suatu pagi Dara jatuh dari kursi rodanya, namun tidak ada seorangpun di dalam rumah
His disillusionment with this makes Dara have the power to move his wheelchair towards the complex park	Rasa kecewanya terhadap hal tersebut membuat Dara memiliki kekuatan untuk menggerakan kursi rodanya ke arah taman komplek
Amir was a good boy and very understanding. He still receives the money.	Amir adalah anak yang baik dan sangat pengertian. Ia tetap menerima uang itu
For a thousand rupiah, Amir can buy a krupuk or a fry-up in the cafeteria	Dengan uang seribu rupiah, Amir bisa membeli krupuk atau sebuah gorengan di kantin
Sometimes the owner of the canteen pity sees Amir and gives him fried or peanuts as a bonus	Kadang-kadang si pemilik kantin kasihan melihat Amir dan memberinya gorengan atau kacang sebagai bonus
Despite his difficult life, Amir always looks cheerful and cheerful	Walaupun hidupnya susah, Amir selalu terlihat riang dan ceria
he left for school in a carefree move. He always greets the neighbors politely	ia berangkat ke sekolah dengan langkah yang riang. Ia selalu menyapa para tetangga dengan santun
About 100 metres from his school, he saw an elderly father guiding his bike	Sekitar 100 meter dari sekolahnya, ia melihat seorang bapak tua yang menuntun sepedanya
The father's bike contained a container containing tofu. Apparently, the father's bicycle tire was deflated	Sepeda bapak itu berisi wadah yang berisi tahu. Nampaknya, ban sepeda bapak itu kempis
Amir immediately offered his help to lead the bike to a tire patcher near his school	Amir langsung menawarkan bantuannya untuk menuntun sepeda itu ke tukang tambal ban di dekat sekolahnya
Incidentally, the owner of the tire patch is already familiar with Amir	Kebetulan pemilik tambal ban itu sudah kenal dengan Amir
He even wants to fill the wind of the seller's bicycle tire knowing it for free	Ia bahkan mau mengisi angin ban sepeda penjual tahu itu secara cuma-Cuma
The seller knows that Mr. Imron said thank you many times	Penjual tahu yang bernama Pak Imron itu mengucapkan terima kasih berkali-kali
Amir is glad Mr Imron was able to return to use the bike to trade	Amir senang Pak Imron bisa kembali menggunakan sepeda itu untuk berdagang
The next day, Mr. Imron deliberately waited for Amir in front of the school gates	Keesokan harinya, Pak Imron sengaja menunggu Amir di depan gerbang sekolah
When Amir came, Mr. Imron gave some short story books	Ketika Amir datang, Pak Imron memberikan beberapa buku cerita pendek
Amir received the book and thanked him	Amir menerima buku itu dan mengucapkan terima kasih
Amir does like to read, but he doesn't like to read short stories for kids	Amir memang gemar membaca, tapi ia tidak suka membaca cerita pendek untuk anak-anak
He prefers to read books about natural knowledge or technology	Ia lebih suka membaca buku tentang pengetahuan alam atau teknologi
Two days after Amir received the storybook from Pak Imron, his teacher announced that tomorrow all students must bring a short story book for children	Dua hari setelah Amir menerima buku cerita dari Pak Imron, gurunya mengumumkan bahwa esok semua murid harus membawa sebuah buku cerita pendek khusus anak-anak
Arriving home, he found the storybook of Mr. Imron under his bed	Sesampainya di rumah, ia menemukan buku cerita dari Pak Imron itu di bawah tempat tidurnya
Amir immediately told his mother about this incident	Amir langsung menceritakan kejadian ini pada ibunya
Starting from his meeting with Mr. Imron, a small gift from the old tofu seller	Mulai dari pertemuannya dengan Pak Imron, hadiah kecil dari penjual tahu yang tua itu
Whoever plants good will reap the good	Barang siapa yang menanam kebaikan, maka ia akan menuai kebaikan
A patient to be dissected lies in the operating room with a pale face	Seorang pasien yang akan dibedah terbaring di kamar operasi dengan muka yang pucat
A young surgeon came in and greeted the patient kindly	Seorang dokter bedah muda masuk sambil menyapa pasien tersebut dengan ramah
You look so scared, don't worry, everything will go well and smoothly	Kamu kelihatan takut sekali, jangan bimbang, semuanya akan berjalan dengan baik dan lancar
A police officer is questioning the accused, a wife who abused her husband	Seorang polisi sedang bertanya kepada terdakwa, seorang istri yang melakukan penganiayaan terhadap suami
In working and studying, having a high spirit is important	Dalam bekerja dan belajar, memiliki semangat yang tinggi adalah hal yang penting
Without passion, work or lessons will feel like a burden	Tanpa semangat, pekerjaan atau pelajaran akan terasa seperti beban
If you're starting to lose your temper, it might be worth taking a break and looking for some entertainment	Jika kamu mulai kehilangan semangat, mungkin ada baiknya istirahat sebentar dan mencari hiburan
Have you ever felt so sick of going to school or to the office for no apparent reason?	Pernahkah kamu merasa sangat muak untuk pergi ke sekolah atau ke kantor tanpa alasan yang jelas?
Work and lessons just make you sick and want to go home soon?	Pekerjaan dan pelajaran hanya membuatmu muak dan ingin segera pulang ke rumah?
If that happens, the sign is that you're feeling saturated.	Jika hal itu terjadi, tandanya kamu sedang merasa jenuh
Feeling saturated and discouraged is a human thing that everyone may have experienced	Merasa jenuh dan kehilangan semangat adalah hal yang manusiawi dan mungkin pernah dialami semua orang
But constantly lethargic and lackluster will only make your situation more difficult	Namun terus menerus lesu dan tak bersemangat hanya akan membuat keadaanmu semakin berat
the burden of work and school doesn't go away, you just cultivate stress on yourself	beban pekerjaan dan sekolah tidak hilang, kamu hanya memupuk stres di dirimu sendiri
When he was in high school, Jordan was rejected when he wanted to join his school's basketball team.	Saat baru duduk di bangku SMA, Jordan pernah ditolak saat ingin mengikuti seleksi masuk tim basket sekolahnya
The main reason at the time was because his body was too short	Alasan utama pada saat itu adalah karena badannya yang terlalu pendek
In addition, he is also considered less proficient in the game	Selain itu, ia juga dinilai kurang mahir dalam permainan tersebut
Jordan was very sad to hear that, but he didn't give up.	Jordan sangat sedih mendengar hal itu, tapi ia tak menyerah
He continues to train vigorously every day at home	Ia tetap berlatih dengan giat setiap hari di rumah
Not only his technique, he also trains his physique very hard and disciplined	Tidak hanya tekniknya, ia juga melatih fisiknya dengan sangat keras dan disiplin
Two years later, he returned to his school team selection and was accepted	Dua tahun berikutnya, ia kembali mengikuti seleksi tim sekolahnya dan diterima
Although he was accepted into the team, he was not immediately satisfied and lazy	Meski sudah diterima dalam tim, ia tidak langsung puas dan bermalas-malasan
He remains diligent in training, even he often comes home late because of additional training	Ia tetap rajin berlatih, bahkan ia sering pulang terlambat karena latihan tambahan
In the 1981 high school competition Jordan proved his hard work	Pada kompetisi SMA tahun 1981 Jordan membuktikan kerja kerasnya
In his first game, he scored 40 points. It also has impressive statistics	Pada game pertamanya, ia berhasil mencetak 40 angka. Ia juga memiliki statistik yang mengesankan
Averaged 25 points per game, and won the high school competition in the same year	Rata-rata 25 angka per game, dan memenangkan kompetisi SMA di tahun yang sama
Since then his basketball career has continued to rise. He joined the University of North Carolina team	Sejak saat itu karier basketnya terus menanjak. Ia bergabung dengan tim Universitas Carolina Utara
He was signed to the Chicago Bulls in 1984.	Kemudian ia mendapat kontrak dan bergabung dalam tim Chicago Bulls pada tahun 1984
Jordan's career in nba professional basketball was brilliant	Karir Jordan di dunia basket professional NBA sangat gemilang
He retired in 2003 and is the second-highest scoring player in a season	Ia pensiun tahun 2003 dan tercatat sebagai pemain yang mencetak angka terbanyak kedua dalam satu musim
Jordan is now an NBA club owner, businessman, and one of basketball's all time legends	Kini Jordan menjadi pemilik klub NBA, pebisnis, dan salah satu legenda basket sepanjang masa
When I was a toddler, my parents divorced and I was raised by my grandmother.	Saat masih balita, orang tuaku bercerai dan aku diasuh oleh nenekku
We live in poverty, I even have to use sacks as my clothes	Kami hidup dalam kemiskinan, aku bahkan harus menggunakan karung sebagai pakaianku
One day, my grandmother got sick and I had to live with my mom.	Suatu hari, nenekku jatuh sakit dan aku harus tinggal dengan ibuku
My mother was a housekeeper who spent most of her time working	Ibuku adalah seorang pembantu rumah tangga yang menghabiskan sebagian besar waktunya untuk bekerja
My hard work paid off, I became a top student and graduated as the best student	Kerja kerasku terbayar, aku menjadi siswa unggulan dan lulus sebagai murid terbaik
I also won several awards in the field of speech	Aku juga memenangkan beberapa penghargaan dalam bidang pidato
I then studied Communications at Tennessee State University.	Aku kemudian mengambil kuliah jurusan Komunikasi di Tennessee State University
In between lectures, I took a job as a broadcaster on local radio	Di sela-sela waktu kuliah, aku mengambil pekerjaan sebagai penyiar di radio lokal
After graduating, I started my television career. It's not easy as a black person to have a career in television	Setelah lulus, aku mulai meniti karir di bidang pertelevisian. Tidak mudah sebagai orang kulit hitam untuk berkarir di dunia televisi
But I had big dreams and didn't give up	Tapi aku memiliki mimpi besar dan tidak menyerah
At the age of nineteen I ended up being the first black woman to be a news anchor.	Di usia sembilan belas tahun aku akhirnya menjadi wanita kulit hitam pertama yang menjadi pembawa berita
The show later became the most watched program in the United States at the time. In 1986	Acara yang kemudian menjelma menjadi program paling banyak di tonton di Amerika Serikat pada saat itu. Pada 1986
One afternoon when the weather was very hot, a small child walked into an ice cream shop	Suatu siang ketika cuaca sedang sangat panas, seorang anak kecil masuk ke dalam toko es krim
The boy looked around for the available ice cream and asked the shopkeeper	Anak itu melihat-lihat es krim yang tersedia lalu bertanya pada penjaga toko
The little boy then sat at the table, a few moments later came the usual vanilla ice cream with the bill	Anak kecil itu lalu duduk di meja, beberapa saat kemudian datanglah es krim vanilla biasa dengan tagihannya
The boy finishes his ice cream, pays the bill at the cashier, then leaves	Anak itu menghabiskan es krimnya, membayar tagihan di kasir, lalu pergi
While cleaning the little boy's desk, the shopkeeper found a 15 cent coin left by the little boy as collateral	Saat membereskan meja anak kecil itu, si penjaga toko menemukan koin 15 sen yang ditinggalkan si anak kecil sebagai jaminan
He also felt guilty for being rude towards the boy	Ia pun merasa bersalah telah bersikap kasar terhadap anak itu
One afternoon, a weasel was sitting back and enjoying the breeze	Suatu siang, seekor musang sedang duduk santai menikmati angin sepoi-sepoi
Shortly thereafter, a fox came to prey on him.	Tak lama kemudian, datanglah seekor rubah yang hendak memangsanya
Foxes who feel confident will not lose against ferrets also approved the proposal	Rubah yang merasa percaya diri tak akan kalah melawan musang pun menyetujui usulan itu
Five minutes later, the ferret came out carrying the fox's thigh	Lima menit kemudian, musang itu keluar sambil membawa paha rubah
Weasel returned to his place of sunbathing earlier. Soon there appeared a wolf who wanted to prey on him	Musang kembali ke tempatnya berjemur tadi. Tak lama kemudian muncul seekor serigala yang hendak memangsanya
Twenty minutes later the ferret came out with a wolf's thigh	Dua puluh menit kemudian musang itu keluar dengan menggondol paha serigala
The afternoon came and it got darker. The weasel then screams into his hole	Sore pun tiba dan hari semakin gelap. Musang kemudian berteriak ke dalam lubangnya
A moment later a tiger appeared from inside the hole. The tiger said, 'That's good for your idea.'	Sesaat kemudian muncul sesosok harimau dari dalam lubang. Harimau itu berkata, ‘Bagus juga idemu.’
In ancient times, there was a king who loved to go out of the palace and observe his people	Pada zaman dahulu, ada seorang raja yang senang pergi keluar istana dan mengamati rakyatnya
One day, he decided to put a large rock at a crossroads and hide in the bush	Suatu hari, ia memutuskan untuk menaruh sebuah batu besar di persimpangan jalan lalu bersembunyi di semak
After a few hours, two merchants appeared to ride in a horse-drawn carriage	Setelah beberapa jam, muncul dua orang pedagang yang menaiki kereta kuda
Seeing the boulders blocking the road, they grumbled and chose a detour	Melihat batu besar yang menghalangi jalan, mereka menggerutu dan memilih jalan memutar
A few hours after the merchant passed by, a farmer appeared to be carrying vegetables	Beberapa jam setelah pedagang itu lewat, muncul seorang petani yang memikul sayur-sayuran
Seeing a large rock blocking his path, he put his vegetables on the side of the road and started pushing the stone	Melihat batu besar menghalangi jalannya, ia pun menaruh sayurannya di tepi jalan dan mulai mendorong batu itu
The farmer then returned to where he put his vegetables	Petani itu kemudian kembali ke tempat ia meletakkan sayurannya
Little by little the boulder can be shifted and the road back to normal	Sedikit demi sedikit batu besar itu bisa digeser dan jalan kembali normal
He found a bag of gold coins along with a note from the king	Ia menemukan sekantung koin emas beserta sebuah catatan dari raja
There's a businessman who owes an old loan shark	Ada seorang pengusaha yang berhutang pada seorang rentenir tua
The loan shark is known to be attracted to the businessman's daughter	Rentenir itu diketahui tertarik dengan anak perempuan si pengusaha
One day, he came up with an offer to the businessman	Suatu hari, ia datang dengan sebuah penawaran kepada si pengusaha
He was willing to let the businessman's debt be allowed to marry his son	Ia bersedia mengikhlaskan hutang si pengusaha asal diperbolehkan menikahi anaknya
The businessman also rejected an offer from the loan shark. However, the loan shark did not give up and submitted a new offer	Si pengusaha pun menolak tawaran dari si rentenir. Tapi, rentenir itu tidak menyerah dan mengajukan sebuah penawaran baru
He would take two stones and put them in a bag	Ia akan mengambil dua batu dan dimasukkannya ke dalam kantung
The businessman is welcome to take a stone from the bag	Si pengusaha dipersilahkan mengambil satu batu dari kantung itu
If it turns out that the black stone was taken, then the debt of the businessman will be erased but his daughter will be married to the loan shark	Jika ternyata yang diambil batu hitam, maka hutang si pengusaha akan dihapus tapi anak perempuannya akan dinikahi si rentenir
While picking up the stone, the businessman saw the loan shark put two black stones in the bag	Saat mengambil batu, pengusaha itu melihat si rentenir memasukkan dua batu hitam ke kantung
The businessman also approved the proposal. They then took the stone from the yard	Si pengusaha pun menyetujui usulan tersebut. Mereka kemudian mengambil batu dari pekarangan
The businessman then thinks hard to get out of that unfortunate situation.	Pengusaha lalu berpikir keras untuk keluar dari situasi yang tak menguntungkannya itu
When the bag was thrust, he grabbed a stone and pretended to stumble and drop the stone	Saat kantung disodorkan, ia mengambil satu batu lalu ia pura-pura tersandung dan menjatuhkan batunya
Maybe we can see the color of the remaining stones, because I definitely took the stone the other way around	Mungkin kita bisa melihat warna batu yang tersisa, karena saya pasti mengambil batu yang sebaliknya
I want them to give on the basis of gratitude for being reminded to always be grateful	Saya ingin mereka memberi atas dasar terima kasih karena telah diingatkan untuk selalu bersyukur
The man continued, "In addition to supplementing your income	Pria itu melanjutkan kata-katanya, “Selain untuk menambah penghasilanmu
One day a little boy walked into a famous restaurant	Pada suatu hari seorang anak kecil masuk ke sebuah restoran terkenal
With a jovial pace and a little running, the little boy sat on one of the empty benches there	Dengan langkah riang dan sedikit berlari, anak kecil itu duduk di salah satu bangku kosong di sana
The little boy then raised his hand to call one of the restaurant's waiters	Anak kecil itu kemudian mengangkat tangannya untuk memanggil salah satu pelayan restoran
A maid immediately came to the little boy with a food menu book	Seorang pelayan perempuan pun segera datang menghampiri anak kecil itu dengan membawa buku menu makanan
The child asked while pointing at one of the pictures displayed on the wall of the restaurant	Si anak balik bertanya sambil menunjuk salah satu gambar yang terpampang di tembok restoran
How much does a strawbery and chocolate-studded ice cream cost?	Berapa harga satu porsi es krim bertabur strawbery dan coklat itu?
The boy then put his hand in his pocket and pulled out some coins and counted them	Anak itu kemudian memasukkan tangannya ke dalam saku dan mengeluarkan beberapa keping uang receh dan menghitungnya
The waiter immediately returned to the kitchen. Moments later the waiter returns to the child's table carrying his order	Pelayan itu segera kembali ke dapur. Beberapa saat kemudian pelayan kembali ke meja si anak sambil membawa pesanannya
The boy then put his hand in the other pocket, he pulled out the rest of the money.	Anak itu kemudian memasukkan tangannya ke saku yang lain, dia mengeluarkan recehan lagi
The boy immediately ate the ice cream slowly.After the ice cream is finished eating	Anak itu pun segera memakan es krim tersebut dengan lahap. Setelah es krim selesai dimakan
The waiter returned to see the boy while carrying a payment note	Pelayan kembali menemui anak itu sambil membawa nota pembayaran
One day an old lady walked down a hill	Pada suatu hari seorang wanita tua berjalan menyusuri bukit
Accidentally, his eyes were fixed on a shiny stone that was on the sidelines of a large rock	Tak sengaja, matanya tertuju pada sebuah batu mengkilat yang berada di sela-sela batu besar
The stone is approximately the size of an adult's fist	Batu itu kurang lebih sebesar kepalan tangan orang dewasa
With various efforts, he achieved and held the sparkly stone	Dengan berbagai usaha, diraih dan dipegangnya batu gemerlap itu
At that moment, through a young man who was looking for firewood	Pada saat itu pula, lewat seorang pria muda yang sedang mencari kayu bakar
It appears from his wear, that the man is a poor man	Tampak sekali dari pakainnya, bahwa lelaki itu adalah orang miskin
The man saw a shiny stone held by the elderly grandmother, and surprised her when she saw a diamond that big	Lelaki itu melihat batu mengkilat yang dipegang oleh nenek tua, dan terperanjatlah dia ketika melihat sebuah berlian sebesar itu
Half in disbelief, the man immediately accepts and takes home the big diamond	Setengah tidak percaya, lelaki itu segera menerima dan membawa pulang berlian besar itu
The next day, the man decides to pawn his diamond	Besoknya, si lelaki memutuskan untuk menggadaikan berlian miliknya
The money from the diamond pawn turned out to be quite large, and that money was what he used as venture capital	Uang hasil gadai berlian itu ternyata cukup besar, dan uang itulah yang ia gunakan sebagai modal usaha
Year after year passed, and finally the man grew up to be a wealthy businessman	Tahun demi tahun dilalui, dan akhirnya lelaki itu tumbuh berkembang menjadi seorang pengusaha yang kaya-raya
But somehow, slowly but surely there began to be a change in the man	Tapi entah kenapa, perlahan namun pasti mulai ada perubahan di diri lelaki itu
The diamond that was once pawned has been redeemed again	Berlian yang dulu digadai itupun sudah dapat ditebusnya kembali
All that exists now is people who want to use themselves.	Yang ada sekarang hanyalah orang-orang yang mau memanfaatkan dirinya
Various competitions and lack of support from those closest to him, eventually made the man's efforts fall	Berbagai persaingan dan minimnya dukungan dari orang-orang terdekatnya, akhirnya membuat usaha lelaki itupun jatuh
But, it turns out that not all of his possessions are exhausted, he still has a large diamond stone given by a grandmother he met a few years ago	Tetapi, ternyata tidak semua hartanya habis, ia masih memiliki batu berlian besar pemberian seorang nenek yang ia temui beberapa tahun lalu
He now has nothing else. In fact everyone has left it.	Ia sekarang tidak mempunyai apa-apa lagi. Bahkan semua orang sudah meninggalkannya
Somehow, he began to feel sorry why he had to ask for the diamond from the old grandmother	Entah mengapa, ia mulai merasa menyesal kenapa ia harus meminta berlian tersebut dari nenek tua itu
Finally, with various efforts, he tried to find the grandmother back	Akhirnya, dengan berbagai upaya, ia berusaha mencari kembali nenek tersebut
After days of searching, the man finally found his grandmother's house, a small hut in the hills	Setelah berhari-hari mencari, akhirnya lelaki itu menemukan rumah sang nenek, yaitu sebuah gubug kecil di perbukitan
pride and luxury make a person negligent	kesombongan dan kemewahan justru membuat seseorang itu menjadi lalai
Bowing down before the old grandmother, the man returns the diamond	Sambil sujud tersungkur di hadapan sang nenek tua, laki-laki itu mengembalikan berliannya
The message that we can take from this story is that generosity is a real treasure	Adapun pesan yang dapat kita ambil dari cerita ini adalah kedermawanan merupakan harta sesungguhnya
I don't want visitors to give you the money just to feel sorry for you.	Saya tidak ingin pengunjung memberikan uangnya hanya sekedar kasihan sama kamu
I just want to express how lucky people can still see	Saya hanya ingin mengutarakan betapa beruntungnya orang masih bisa melihat
The man replied, 'What a beautiful day, but I can't see it.'	Pria itu menjawab, Saya menulis, ‘Hari yang sangat indah, tetapi saya tidak bisa melihatnya.’
The child thanks the man, then asks what the man wrote on his board	Si anak berterima kasih kepada pria itu, lalu menanyakan apa yang ditulis sang pria di papan miliknya
Some time later the man returned to see the child and greeted him	Beberapa waktu kemudian pria itu kembali menemui si anak lalu menyapanya
In less than an hour, the boy's can was almost full.A wonderful fortune for the boy	Kurang dari satu jam, kaleng anak itu sudah hampir penuh. Sebuah rejeki yang luar biasa bagi anak itu
Smiling, the man then returns the board, then leaves it	Sambil tersenyum, pria itu kemudian mengembalikan papan tersebut, lalu pergi meninggalkannya
Then the man asked for the board the boy was carrying, flipped it over, and wrote a few words on it	Lalu pria itu meminta papan yang dibawa anak itu, membaliknya, dan menuliskan beberapa kata di atasnya
The man looked at and noticed the writing displayed on the board	Pria itu memandang dan memperhatikan tulisan yang terpampang pada papan
He reached into his pocket, pulled out a few pieces of dime, then put them in the boy's can.	 Ia merogoh sakunya, mengeluarkan beberapa keping uang receh, lalu memasukkannya ke dalam kaleng anak itu
There's a man who happened to pass by in front of the little boy.	Ada Seorang pria yang kebetulan lewat di depan anak kecil itu
While his hands held a sign that read "I am blind, have mercy on me	Sedangkan kedua tangannya memegang sebuah papan yang bertuliskan “Saya buta, kasihanilah saya
A used can stood upright in front of the boy with only a few pieces of dime in it	Sebuah kaleng bekas berdiri tegak di depan anak itu dengan hanya beberapa keping uang receh di dalamnya
He is a beggar who expects mercy from the visitors	Dia adalah pengemis yang mengharapkan belas kasihan dari para pengunjung
A blind child sits on an entrance staircase at a supermarket	Seorang anak buta duduk di sebuah tangga pintu masuk pada sebuah supermarket
Even if no one loves you anymore, you remain special to Him who created you	Bahkan jika sudah tidak ada lagi yang menyayangi Anda, Anda tetap istimewa bagi Dia yang menciptakan Anda
You are a special and high-value person, especially for the people who love you	Anda adalah sosok yang spesial dan bernilai tinggi, terutama bagi orang-orang yang menyayangi Anda
You have an important role in the life around you	Anda memiliki peran penting di dalam kehidupan di sekitar Anda
You are valuable and valuable to those around you	Anda bernilai dan berharga bagi orang-orang di sekitar Anda
Once born a human being, forever you remain a human being	Sekali dilahirkan sebagai seorang manusia, selamanya Anda tetap menjadi manusia
But actually it can never change your worth as a human being	Tetapi sebenarnya itu semua tidak pernah bisa merubah nilai Anda sebagai seorang manusia
One hundred dollars is still a hundred dollars, can still be used to buy goods	Seratus dollar ini tetap seratus dollar, masih bisa dipakai untuk membeli barang
You want, because you know as dirty as it looks, this money will not change its value	Anda mau, karena Anda tahu sekotor apapun bentuknya, uang ini tidak akan berubah nilainya
Whatever I have done to this money turns out not to affect your desire to have it	Apapun yang telah saya lakukan terhadap uang ini ternyata tidak mempengaruhi keinginan Anda untuk memilikinya
The money that used to look neat has now turned into a bent-bent	Uang yang tadinya tampak rapi sekarang sudah berubah menjadi bertekuk-tekuk tidak karuan
The motivator then squeezed the hundred dollar bill	Motivator tersebut lalu meremas-remas uang seratus dollar itu
All the audience raised their hands in approval. Some of them with their own smiles	Semua hadirin mengangkat tangannya tanda setuju. Beberapa diantaranya sambil senyum-senyum sendiri
The money looks very new." Who wants this money?	Uang itu tampak masih sangat baru. “Siapa yang mau uang ini?
Calmly, the motivator pulls a hundred dollars out of his pocket.	Dengan tenang, motivator mengeluarkan selembar uang seratus dollar dari sakunya
Their eyes looked towards the motivator, as if hoping for a new enlightenment gained	Mata mereka memandang ke arah motivator itu, seakan mengharap ada pencerahan baru yang didapatkan
About 300 well-dressed employees have gathered and sat quietly in their seats	Sekitar 300 pegawai berpakaian rapi sudah berkumpul dan duduk tenang di kursinya masing-masing
A motivator of the world stands on the stand. Yes, he is tasked with motivating	Seorang motivator dunia berdiri di atas mimbar. Ya, dia memang bertugas untuk memberi motivasi
Then he said to his disciples, is this jar full	Kemudian berkata kepada murid-muridnya, apakah toples ini sudah penuh
When class started, he picked up an empty jar and filled it with glof balls	Saat kelas dimulai, dia mengambil toples kosong dan mengisi dengan bola glof
Because there's no guarantee that we can live any longer in this world.	Karena tidak ada yang menjamin bahwa kita bisa hidup lebih lama lagi didunia ini
Let's use this life process as best we can	Mari kita gunakan proses hidup yg kita lalui ini dengan sebaik baiknya
He would pause for a drink before continuing his move	Ia akan berhenti sejenak untuk minum sebelum melanjutkan langkahnya
Just like someone who's on a long journey.	Seperti halnya seseorang yang tengah melakukan perjalanan panjang
The inhabitants of the earth always change, from generation to generation – from descendant to descendant	Penghuni bumi selalu berganti, dari generasi ke generasi – dari keturunan ke keturunan
That's how life is, man, anyone knows life is a short process.	Begitulah hidup kawan, Siapapun tahu hidup adalah sebuah proses yang singkat
Maybe someday I'll bequeath this house to one of my children	Mungkin kelak saya akan mewariskan rumah ini pada salah satu anak saya
But three years ago my father died, then my wife and I decided to move	Tetapi tiga tahun yang lalu bapak saya meninggal, lalu saya dan istri saya memutuskan untuk pindah
After my grandfather died, my father and mother lived here	Sesudah kakek saya meninggal, bapak dan ibu saya tinggal di sini
So he decided to stay at the house he met.	Maka ia memutuskan untuk menginap di rumah yang ditemuinya
Public transport was running out and he had trouble getting home	Angkutan umum sudah habis dan ia kesulitan untuk pulang
A young boy playing outside the city	Seorang anak muda yang sedang bermain di luar kota
When trouble comes to you, how do you deal with it? Are you a potato, an egg, or a coffee bean?	Ketika kesulitan mendatangimu, bagaimana caramu dalam menghadapinya? Apakah kamu adalah sebuah kentang, telur, atau biji kopi?
However, ground coffee beans are the most unique. Once the coffee beans are exposed to boiling water, the coffee beans change the water and create something new	Namun, biji kopi tanah yang paling unik. Setelah biji kopi terkena air mendidih, biji kopi mengubah air dan menciptakan sesuatu yang baru
Fragile eggs, with a thin outer shell protect the inside of a liquid egg until put in boiling water	Telur yang rapuh, dengan kulit luar tipis melindungi bagian dalam telur yang cair sampai dimasukkan ke dalam air mendidih
The potatoes were strong and hard. But when put in boiling water, the ketang becomes soft and weak	Kentang itu kuat dan keras. Namun ketika dimasukkan ke dalam air mendidih, ketang tersebut menjadi lunak dan lemah
Then the father explained that potatoes, eggs and coffee beans have each faced the same difficulties	Kemudian sang ayah menjelaskan bahwa kentang, telur dan biji kopi masing-masing telah menghadapi kesulitan yang sama
Then he scoops the coffee and puts it in a cup	Kemudian ia menyendok kopi dan meletakkannya ke dalam cangkir
And put it in a bowl. He lifts the egg and puts it in a bowl	Dan menempatkannya ke dalam mangkuk. Ia mengangkat telur dan meletakkannya di mangkuk
After twenty minutes, he turned off the stove. He took potatoes from the pan	Setelah dua puluh menit, ia mematikan kompor tersebut. Ia mengambil kentang dari panci
Her daughter complained and couldn't wait, wondering what her father had done	Putrinya mengeluh dan tidak sabar menunggu, bertanya-tanya apa yang telah ayahnya lakukan
Without saying a word to his daughter	Tanpa mengucapkan sepatah kata apapun kepada putrinya
Then he sat down and let the three pans on the stove boil	Kemudian ia duduk dan membiarkan ketiga panci tersebut di atas kompor agar mendidih
After the three pans began to boil, he put some potatoes in a saucepan	Setelah tiga panci tersebut mulai mendidih, ia memasukkan beberapa kentang ke dalam sebuah panci
His father, who was also a chef, took him to the kitchen. He filled three pots with water and put them on a high heat	Ayahnya yang juga seorang koki membawanya ke dapur. Ia mengisi tiga panci dengan air dan menaruhnya di atas api yang besar
Then another problem soon followed to be solved	Kemudian masalah yang lainnya segera menyusul untuk dapat diselesaikan
He's tired of fighting and fighting all the time. It seems that only one of his problems can be solved	Dia lelah berjuang dan berjuang sepanjang waktu.Tampaknya hanya salah satu dari masalahnya yang dapat ia selesaikan
Failure is part of learning. We must not give up on fighting in your life	Kegagalan adalah bagian dari pembelajaran. Kita tidak boleh menyerah untuk berjuang di dalam hidup anda
One day, a daughter complained to her father that her life was miserable	Pada suatu hari, ada seorang anak perempuan yang mengeluh kepada ayahnya bahwa hidupnya sengsara
It is clear that elephants can break away from their bonds at any time	Jelas sekali bahwa gajah bisa melepaskan diri dari ikatan mereka kapan saja
And sometimes people adore diamonds more than they worship their own partners	Dan terkadang orang lebih memuja berlian daripada memuja pasangannya sendiri
One day a father and his son were sitting chatting by the river	Suatu hari seorang ayah dan anaknya sedang duduk berbincang-bincang di tepi sungai
Father said to his son, "Look at my son, water is so important in this life, without water we will all die."	Kata Ayah kepada anaknya, “Lihatlah anakku, air begitu penting dalam kehidupan ini, tanpa air kita semua akan mati.”
He suddenly became agitated and wanted to know what water was, which he said was so important in this life	Ia mendadak menjadi gelisah dan ingin tahu apakah air itu, yang katanya begitu penting dalam kehidupan ini
At the same time, a small fish listens to the conversationfrom beneath the surface of the water	Pada saat yang bersamaan, seekor ikan kecil mendengarkan percakapan itudari bawah permukaan air
The little fish swims from upstream to downstream while asking each fish it encounters	Ikan kecil itu berenang dari hulu sampai ke hilir sungai sambil bertanya kepada setiap ikan yang ditemuinya
It turns out that all the fish do not know where the water is, the little fish is getting loose, then he swims towards the spring	Ternyata semua ikan tidak mengetahui dimana air itu, si ikan kecil semakingelisah, lalu ia berenang menuju mata air
No matter what problems come, even if it's a big test we're going through, it's hard for us to face.	Walau apapun masalah yang datang melanda, walau besar ujian yang kita tempuh, walau berat untuk kita hadapi
Life and happiness are all around us and we are living, as we will and strive to understand them	Kehidupan dan kebahagiaan ada di sekeliling kita dan sedang kita jalani, selagi kita mau dan berupaya untuk memahaminya
Although it is difficult for us to live, then face it all with calmness and sincerity	Walau sukar untuk kita jalani, maka hadapi la semuanya dengan ketenangan dan Keikhlasan
Because life is always sweet, sometimes bitter, always like, suddenly becomes grief	Kerana hidup ini sentiasa ada manisnya, kadang-kadang pahit, selalunya suka, tiba-tiba menjadi duka
The clouds were a little cloudy, as Yani's little legs ran around happily over the streets of Karet red light district	Awan sedikit mendung, ketika kaki kaki kecil Yani berlari-lari gembira di atas jalanan Menyeberangi kawasan lampu merah Karet
His right hand holds the ice cream while occasionally lifting it into his mouth to taste	Tangan kanannya memegang es krim sambil sesekali mengangkatnya ke mulutnya untuk dicicipi
Yani and her father enter karet public cemetery	Yani dan ayahnya memasuki wilayah pemakaman umum Karet
Her oversized red shirt waved in the wind	Baju merahnya yang kebesaran melambai lambai di tiup angin
Returning home from the funeral, Yani's father looks agitated on his prayer mat	Pulang dari Pemakaman, ayah Yani tampak gelisah di atas sajadahnya
Life is something that ends in death the purpose of life for a Muslim is to worship and keep the mandate of God	Kehidupan adalah sesuatu yang berakhir pada kematian tujuan dari hidup bagi seorang muslim adalah beribadah dan menjaga amanat Allah
Given to us as caliphs on the face of the earth, therefore if we are still given the opportunity to live then make the best use of it	Yang diberikan kepada kita sebagai khalifah dimuka bumi ini, karna itu jika kita masih diberi kesempatan untuk hidup maka pergunakanlah dengan sebaik mungkin
A boy spends free time hiking with his father	Seorang bocah mengisi waktu luang dengan kegiatan mendaki gunung bersama ayahnya
Suddenly the boy tripped over the tree root and fell." Ouch!" his screams broke	Tiba-tiba si bocah tersandung akar pohon dan jatuh. “Aduhh!” jeritannya memecah
Again he was surprised when a voice from there replied with a similar swearing.He asked his father	Lagi-lagi ia terkejut ketika suara dari sana membalasnya dengan umpatan serupa. Ia bertanya kepada sang ayah
Life gives feedback on all your words and actions	Kehidupan memberi umpan balik atas semua ucapan dan tindakanmu
In other words, our lives are a reflection or a reflection of our actions	Dengan kata lain, kehidupan kita adalah sebuah pantulan atau bayangan atas tindakan kita
If you want to get more love in this world, yes create love in your heart	Bila kamu ingin mendapatkan lebih banyak cinta di dunia ini, ya ciptakan cinta di dalam hatimu
If you want your team to be highly capable, then improve that.	Bila kamu menginginkan tim kerjamu punya kemampuan tinggi, ya tingkatkan kemampuan itu
Life will give back everything you've given him.Remember, life is not a coincidence but a shadow of you	Hidup akan memberikan kembali segala sesuatu yang telah kau berikan kepadanya. Ingat, hidup bukan sebuah kebetulan tapi sebuah bayangan dirimu
When I was a kid, dad already had a phone in our house	Waktu saya masih kecil, ayah sudah memiliki telepon di rumah kami
This is the early phone, black, attached to the wall, and if you want to contact the operator	Inilah telepon masa awal, warnanya hitam, di tempelkan di dinding, dan kalau mau menghubungi operator
We have to turn a round and have it connected to another phone number.	Kita harus memutar sebuah putaran dan minta disambungkan dengan nomor telepon lain
In a short time, I found that, if the round was turned, a friendly, sweet voice would say	Dalam waktu singkat, saya menemukan bahwa, kalau putaran di putar, sebuah suara yang ramah, manis, akan berkata
He knows the phone numbers of restaurants, hospitals, even the phone numbers of cake shops at the end of the city	Ia tahu nomor telepon restoran, rumah sakit, bahkan nomor telepon toko kue di ujung kota
The first experience with the operator happened when no one was home	Pengalaman pertama dengan sang operator terjadi waktu tidak ada seorangpun dirumah
Since then I always call the operator if I need anything	Sejak saat itu saya selalu menelpon operator kalau perlu sesuatu
Time can not answer the question of earth science, what is the name of the capital of a Country, ask about mathematics	Waktu tidak bisa menjawab pertanyaan ilmu bumi, apa nama ibu kota sebuah Negara, tanya tentang matematika
He also explained that the squirrel I caught was used as a pet	Ia juga menjelaskan bahwa tupai yang saya tangkap untuk dijadikan binatang peliharaan
I called the operator and reported this sad news	Saya telpon sang operator dan melaporkan berita duka cita ini
He listens to all the complaints, then utters the word entertainment that adults usually say for young children	Ia mendengarkan semua keluhan, kemudian mengutarakan kata kata hiburan yang biasa diutarakan orang dewasa untuk anak kecil
This incident lasted until I was 9 years old. We moved to another city.	Kejadian ini berlangsung sampai saya berusia 9 tahun. Kami sekeluarga kemudian pindah kota lain
I grew up as a teenager, then a young man, and childhood memories I always enjoyed	Saya tumbuh jadi remaja, kemudian anak muda, dan kenangan masa kecil selalu saya nikmati
How patient this woman is. How understanding and willing to visit small children	Betapa sabarnya wanita ini. Betapa penuh pengertian dan mau meladeni anak kecil
A few years later, as a student, I studied a trip to my home town	Beberapa tahun kemudian, saat jadi mahasiswa, saya studi trip ke kota asal
As soon as I arrived, I called the phone office, and asked for a	Segera sesudah saya tiba, saya menelpon kantor telepon, dan minta bagian
Three months later I returned to my home town. Call the operator.Very different and foreign sounds	Tiga bulan kemudian saya balik ke kota asal. Telpon operator. Suara yang sangat beda dan asing
I'm asking you to talk to an operator whose name is Sali.	Saya minta bicara dengan operator yang namanya Sali
Sorry to tell you this, Saly has been working part-time for the last few years due to illness.	Maaf untuk kabarkan hal ini, Saly beberapa tahun terakhir bekerja paruh waktu karena sakit sakitan
Sali left you a message.He wrote it on a piece of paper	Sali meninggalkan sebuah pesan buat Anda. Dia menulisnya di atas sepotong kertas
I put the handset down. I know what Sali means	Saya meletakkan gagang telepon. Saya tahu apa yang Sali maksudkan
Never once ignore, how you touch other people's lives	Jangan sekali sekali mengabaikan, bagaimana Anda menyentuh hidup orang lain
The attention sally has given her is so valuable to ryan that this is how everyone should behave towards her work.	Perhatian yang diberikan sally begitu berharga bagi ryan beginilah seharusnya sikap setiap orang terhadap pekerjaannya
Always take the time to pay as much attention as possible to people in need	Selalu menyempatkan diri untuk memberi perhatian sebisa mungkin kepada orang yang membutuhkan
Until one time the passenger sitting in the back seat shouted	Hingga suatu ketika penumpang yang duduk di kursi belakang berteriak
All efforts to provide for the family must be done with hard work, unyielding, discipline and sincerity	Segala upaya untuk menafkahi keluarga harus dilakukan dengan kerja keras, pantang menyerah, disiplin dan ikhlas
A woman was waiting at the airport one night	Seorang wanita sedang menunggu di bandara suatu malam
There's still a few hours before the flight time. To waste his time, he bought a book and a bag of cookies at the store	Masih ada beberapa jam sebelum jadwal terbangnya tiba. Untuk membuang waktu,ia membeli buku dan sekantong kue di toko
In his preparedness he saw the man next to him so bravely take one or two of the cakes	Dalam keasyikannya tersebut ia melihat lelaki disebelahnya dengan begitu berani mengambil satu atau dua dari kue
While sitting down the woman read the book she had just bought	Sambil duduk wanita tersebut membaca buku yang baru saja dibelinya
The woman tries to ignore the noise	Wanita tersebut mencoba mengabaikan agar tidak terjadi keributan
He reads, chews cakes and sees clocks. While the brave Cookie Thief spends his supplies	Ia membaca, mengunyah kue dan melihat jam. Sementara si Pencuri Kue yang pemberani menghabiskan persediaannya
When only one cake was left, he wondered what the man would do	Ketika hanya satu kue tersisa, ia bertanya-tanya apa yang akan dilakukan lelaki itu
He grew increasingly annoyed as the minutes passed. The woman also thought	Ia semakin kesal sementara menit-menit berlalu. Wanita itupun sempat berpikir
He boarded the plane and sat in his seat, then searched for his book, which he almost finished reading	Ia naik pesawat dan duduk di kursinya, lalu mencari bukunya, yang hampir selesai dibacanya
As he reached into his bag, he held his breath in shock	Saat ia merogoh tasnya, ia menahan napas dengan kaget
So the cake was hers and she tried to share it	Jadi kue tadi adalah miliknya dan ia mencoba berbagi
Too late to apologize, he was saddened	Terlambat untuk minta maaf, ia tersandar sedih
That he was the rude, thank and he was the cookie thief.	Bahwa sesungguhnya dialah yang kasar, tak tahu terima kasih dan dialah pencuri kue itu
In this life the story of cake thieves like that often happens	Dalam hidup ini kisah pencuri kue seperti tadi sering terjadi
We often think and see others with our own glasses	Kita sering berprasangka dan melihat orang lain dengan kacamata kita sendiri
On the way he passed the workshop of a furniture maker	Di tengah perjalanan dia melewati bengkel seorang pembuat mebel
The shop owner's eyes were trained to see the wood on the man's back	Mata pemilik bengkel sudah terlatih melihat kayu yang dipanggul lelaki itu
The wood is beautiful, the color is good, and the quality is famous. Incidentally at that time there was a furniture order	Kayunya indah, warnanya bagus, dan mutunya terkenal. Kebetulan pada waktu itu ada pesanan mebel
He offered the man $100. Looks hesitant in the man's eyes	Dia menawarkan uang sejumlah 100 dollar kepada lelaki itu. Terlihat ragu-ragu di mata laki-laki itu
But the craftsman convinced him and was able to offer him ready-made furniture for the man to choose from.	Namun pengrajin itu meyakinkannya dan dapat menawarkannya mebel yang sudah jadi agar dipilih lelaki itu
It just so happens that there's a closet that his wife would love. He swapped the wood and borrowed a cart to carry the cupboard	Kebetulan di sana ada lemari yang pasti disukai istrinya. Dia menukar kayu tersebut dan meminjam sebuah gerobak untuk membawa lemari itu
When the man seemed hesitant, the woman raised her offer to $250	Ketika lelaki itu nampak ragu-ragu, si wanita menaikkan tawarannya menjadi 250 dollar
On the way he passed through a new housing estate. A woman decorating a house	Di tengah perjalanan dia melewati perumahan baru. Seorang wanita yang sedang mendekorasi rumah
At the village door he paused and wanted to make sure the money he received	Di pintu desa dia berhenti sejenak dan ingin memastikan uang yang ia terima
The man agreed. Then return the cart to the craftsmen and go home	Lelaki itupun setuju. Kemudian mengembalikan gerobak ke pengrajin dan beranjak pulang
So pleased, the man begins to think about what he will do with the fortune he receives	Begitu senangnya, lelaki tersebut mulai memikirkan apa yang akan dia lakukan dengan rejeki yang diterimanya
He could make some shelves for his wife because his wife once said they had nowhere to store the jar.	Dia bisa membuatkan beberapa rak untuk istrinya karena istrinya pernah berkata mereka tak punya tempat untuk menyimpan toples
When passing through a hardware store, he saw several pieces of wood being sold	Ketika melewati sebuah toko perkakas, dilihatnya beberapa lembar kayu sedang diobral
After buying the wood for $30, he grabbed the wood and went home	Sesudah membeli kayu seharga 30 dollar, dia memanggul kayu tersebut dan beranjak pulang
When the man was walking down a deserted street, suddenly his feet saw something	Ketika laki-laki itu tengah menyusuri jalanan sepi, tiba-tiba kakinya melihat sesuatu
Out of curiosity he bent down and picked it up	Karena merasa penasaran ia membungkuk dan mengambilnya
The man followed the Teller's advice, taking the coins to the collector	Lelaki itu pun mengikuti anjuran si Teller, membawa koinnya ke kolektor
His children have not bought clothes for a long time, his wife is often grumpy because he can not buy household items	Anak-anaknya sudah lama tak dibelikan pakaian, istrinya sering marah-marah karena tak dapat membeli barang-barang rumah tangga
While his neighbors were busy filling the house with luxury items	Sementara para tetangganya sibuk memenuhi rumah dengan barang-barang mewah
The man can't stand this condition any more, and he's not sure that his journey this time will bring good luck	Laki-laki itu sudah tak tahan dengan kondisi ini, dan ia tidak yakin bahwa perjalanannya kali inipun akan membawa keberuntungan
Sir told me that the money raised I bought something that you do not have	Tuan berpesan agar uang yang terkumpul saya belikan sesuatu yang belum tuan punya
At that time I thought, sir already have everything. The only thing my lord hasn't had is love in their hearts.	Ketika itu saya berpikir, tuan sudah memiliki segala sesuatu. Satu-satunya hal yang belum tuanku punyai adalah cinta di hati mereka
I used to tell you to collect debts to the poor people of this village.	Dulu tuan pernah menyuruh saya menagih hutang kepada para penduduk miskin kampung ini
So I distributed the money to them on behalf of the master.Now the lord reaps their love	Maka saya membagikan uang itu kepada mereka atas nama tuan. Sekarang tuan menuai cinta mereka
Who are the villagers, and why would they be kind enough to help me?	Siapakah para penduduk kampung itu, dan mengapa mereka sampai mau berbaik hati menolongku?
When they arrived in a village, somehow the inhabitants greeted them cheerfully and warmly	Ketika tiba di sebuah kampung, entah mengapa para penduduknya menyambut mereka dengan riang dan hangat
When the fool comes home and reports what he has done, the master shakes his head	Ketika si bodoh pulang dan melaporkan apa yang telah dilakukannya, sang tuan geleng-geleng kepala
Not to mention the flood disaster that cost all his possessions	Belum lagi bencana banjir yang menghabiskan semua harta bendanya
The residents are very happy. They praised the generosity of the master	Para penduduk sangat gembira. Mereka memuji kemurahan hati sang tuan
After thinking for a long time, the fool found the answer	Setelah berpikir lama, si bodoh pun menemukan jawabannya
He went back to the poor village. Then he handed over the money he had collected to the villagers.	Dia kembali ke perkampungan miskin tadi. Lalu dia bagikan lagi uang yang sudah dikumpulkannya tadi kepada para penduduk
The people were very poor, and at that time there was a long drought.	Para penduduk itu memang sangat miskin, dan pula ketika itu tengah terjadi kemarau panjang
Finally the fool managed to get the job done. On the way home he remembered his master's message	Akhirnya si bodoh berhasil jua menyelesaikan tugasnya. Dalam perjalanan pulang ia teringat pesan tuannya
The stove is a concept of energy conversion or what is called the law of conservation of energy.	Kompor merupakan salah satu konsep konversi energi atau disebut dengan hukum kekekalan energi.
In the past, it was still using an oil stove, there was a wick that was used as an intermediary medium for absorbing kerosene	zaman dulu masih menggunakan kompor minyak, ada sumbu yang dijadikan sebagai media perantara untuk menyerap minyak tanah
On the stove now the heat energy comes from electricity or gas	Pada kompor sekarang energi panas tersebut berasal dari listrik atau gas
All the energy in this universe cannot be removed. Energy can only be transformed into other forms of energy.	Semua energi yang ada di alam semesta ini tidak dapat dihilangkan. Energi hanya dapat diubah bentuknya menjadi energi bentuk lain.
Energy is the ability to do work so that an activity can be created	Energi adalah kemampuan untuk melakukan kerja sehingga dapat terciptanya suatu kegiatan
Kinetic energy is the energy caused by the motion of an object that has mass / weight.	Energi kinetik adalah energi yang disebabkan oleh gerak suatu benda yang memiliki massa/berat.
Potential energy is the energy present in an object because the object is located in a force field	Energi potensial adalah Energi yang ada di suatu benda karena letak benda itu berada dalam medan gaya
Mechanical energy is the sum of the kinetic energy and potential energy in an object or system	Energi mekanik adalah Penjumlahan energi kinetik dan energi potensial pada suatu benda atau sistem
Vibration is vibrating. The particles of a substance can move because of the heating process	Vibrasi adalah bergetar. Partikel suatu zat dapat bergerak karena adanya proses pemanasan
Temperature is one of the factors that causes particles to move in a substance so that the particles are said to have the kinetic energy of the particles	Suhu adalah salah satu faktor penyebab partikel bergerak dalam suatu zat sehingga partikel dikatakan memiliki energi kinetik partikel
Indonesian is the mother tongue of this nation. We have used it every day, both in terms of writing and speech.	Bahasa Indonesia adalah bahasa ibu bagi bangsa ini. Kita sudah gunakan setiap harinya, baik dari segi tulisan maupun ucapan.
Even though we have used this language from birth, it still exists. Even though we have used this language from birth, it still exists	Meskipun bahasa ini sudah kita gunakan dari sejak lahir, masih ada saja Meskipun bahasa ini sudah kita gunakan dari sejak lahir, masih ada saja
Lorentz style This style is named Lorentz because the inventor has the last name Lorentz	Gaya Lorentz Gaya ini diberi nama Lorentz karena penemunya bernama belakang Lorentz
The Lorentz force is the force that results from the presence of an electric current in a magnetic field	Gaya Lorentz adalah gaya yang timbul akibat adanya arus listrik dalam suatu medan magnet
if we have a conducting object that is in a magnetic field, then we flow the object with an electric current	jika kita memiliki suatu benda konduktor yang berada di dalam medan magnet, kemudian kita aliri benda tersebut dengan arus listrik
there is a conductor in the form of a wire that is placed between two magnets	terdapat sebuah benda konduktor berupa kawat yang diletakkan di antara dua buah magnet
These magnets have different poles, namely the South pole (South / S) and the North pole (North / N). Then, the wire is energized with an electric current	Magnet ini memiliki kutub yang berbeda, yaitu kutub Selatan (South/S) dan kutub Utara (North/N). Kemudian, kawat tersebut dialiri dengan arus listrik
The wire turns upward. This occurs as a result of the Lorentz Force that arises	Kawat tersebut ternyata membengkok ke atas. Hal ini terjadi akibat adanya Gaya Lorentz yang timbul
The wire will bend in the direction of the resulting Lorentz Force	Kawat akan membengkok sesuai dengan arah Gaya Lorentz yang timbul
The direction of the Lorentz Force is always perpendicular to the direction of the electric current (I) and the direction of the magnetic field (B)	Arah dari Gaya Lorentz selalu tegak lurus dengan arah arus listrik (I) dan arah medan magnet (B)
an electric current flows from one end of the wire to the other as illustrated by the yellow line	arus listrik mengalir dari  salah satu ujung kawat menuju ujung kawat yang lain seperti diilustrasikan oleh garis kuning
The magnetic field points from a North pole magnet on the right to a South pole magnet on the left	Medan magnetnya mengarah dari magnet berkutub Utara di sebelah kanan menuju magnet berkutub Selatan di sebelah kiri
The resulting Lorentz force will point upwards and bend the wire upwards as well.	Gaya Lorentz yang timbul akan mengarah ke atas dan membengkokkan kawat ke arah atas pula.
The trick is to practice using your own hands according to the right hand rule	Caranya yaitu dengan mempraktikkan sendiri menggunakan tanganmu sesuai dengan kaidah tangan kanan
The Lorentz Force formula is used to calculate the amount of Lorentz force that occurs in a magnetic field.	Rumus Gaya Lorentz digunakan untuk menghitung besarnya Gaya Lorentz yang timbul dalam suatu medan magnet.
Heat is heat that can move from objects that have excess heat to objects that lack heat	Kalor merupakan panas yang bisa berpindah dari benda yang memiliki kelebihan kalor menuju benda yang kekurangan kalor
Heat is usually expressed in terms of temperature. In international units, heat is expressed in Joules	Kalor biasanya dinyatakan dalam suhu. Dalam satuan internasional, kalor dinyatakan dengan Joule
1 calorie is defined as the amount of heat needed to heat 1 kg of water by 1⁰C	1 kalori didefinisikan sebagai banyaknya kalor yang diperlukan untuk memanaskan sebanyak 1 kg air sebesar 1⁰C
Specific heat is the amount of heat absorbed or required by 1 gram of a substance to raise the temperature by 1⁰C.	Kalor jenis adalah banyaknya kalor yang diserap atau diperlukan oleh 1 gram zat untuk menaikkan suhu sebesar 1⁰C.
Specific heat is also defined as the ability of an object to release or receive heat	 Kalor jenis juga diartikan sebagai kemampuan suatu benda untuk melepas atau menerima kalor
Each object has a different specific heat, you know. The unit of specific heat is J / kg⁰C	Masing-masing benda mempunyai kalor jenis yang berbeda-beda, lho. Satuan kalor jenis ialah J/kg⁰C
Heat capacity is the amount of heat absorbed by an object with a certain mass to increase the temperature by 1⁰C. The unit for heat capacity in the international system is J / K.	Kapasitas kalor adalah jumlah kalor yang diserap oleh benda bermassa tertentu untuk menaikkan suhu sebesar 1⁰C. Satuan kapasitas kalor dalam sistem international ialah J/K.
The force of motion that exists in an object is influenced by two factors, namely the mass and velocity of the object	Kekuatan gerak yang ada pada benda dipengaruhi oleh dua faktor, yaitu massa dan kecepatan si benda
An object that has high speed but has small mass will have the same power of motion as an object with large mass but low velocity	benda yang memiliki kecepatan tinggi tapi massanya kecil akan memiliki kekuatan gerak yang sama dengan benda bermassa besar tapi kecepatannya rendah
A trontoon with a mass of 20,000 kg is moving at a speed of 10 m / s. Now, a lot of force is needed to stop the trontoon	Sebuah tronton bermassa 20.000 kg bergerak dengan kecepatan 10 m/s. Nah, gaya yang besar dibutuhkan untuk menghentikan laju tronton
More force is needed to stop a small car at high speed than to stop a tronton moving at a low speed	Gaya yang lebih besar dibutuhkan untuk menghentikan laju mobil kecil dengan kecepatan tinggi daripada menghentikan tronton yang bergerak dengan kecepatan rendah
If you want to stop a moving train, more force is required than stopping tronton and small cars	Jika ingin menghentikan kereta yang sedang bergerak, gaya yang lebih besar dibutuhkan daripada menghentikan tronton dan mobil kecil
The types of collisions are distinguished by the change in energy. When two objects experience a perfect elastic or resilient collision,	Jenis-jenis tumbukan dibedakan berdasarkan perubahan energi. Ketika dua benda mengalami tumbukan elastis atau lenting sempurna,
The speed and direction of the first object after the collision will be the same as the speed of the collision of the second object after the collision	Kecepatan dan arah benda pertama setelah tumbukan akan sama dengan kecepatan tumbukan benda kedua setelah tumbukan
This is because one object follows the motion of the other after the collision	Hal ini dikarenakan salah satu benda mengikuti gerak benda yang lainnya setelah tumbukan
Non-resilient collisions usually occur when the "force of motion" of one object is greater than that of another	Tumbukan tak lenting biasanya terjadi ketika ‘kekuatan gerak’ salah satu benda sangat besar dari benda yang lainnya
Small mass objects with low velocity will be carried away in the direction of motion with objects with large mass and large velocity.	Benda bermassa kecil dengan kecepatan rendah akan terbawa arah geraknya dengan benda yang bermassa besar dan kecepatan besar.
earth as well as other planets that move around the sun	bumi dan juga planet-planet lainnya yang bergerak mengelilingi matahari
Kepler's law was discovered by Johannes Kepler who was a mathematician and astronomer from Germany	Hukum Kepler ditemukan oleh Johannes Kepler yang merupakan seorang matematikawan dan astronom asal Jerman
Ancient humans adhered to a geocentric concept, which is an understanding that confirms that the earth is the center of the universe	Manusia zaman dahulu menganut paham geosentris yakni paham yang membenarkan bahwa bumi adalah pusat alam semesta
According to Claudius Ptolomeus a Greek astronomer, the earth is in the center of the solar system and the sun as well as the planets circle the earth in a circular path	Menurut Claudius Ptolomeus seorang astronom Yunani, bumi berada di pusat tata surya dan matahari besera planet-planet mengelilingi bumi pada lintasan melingkar
In 1543, Polish astronomer Nicolaus Copernicus proposed a heliocentric model, namely the earth and other planets that orbit the sun in a circular path.	Tahun 1543 astronom asal Polandia bernama Nicolaus Copernicus mengemukakan model heliosentris yakni bumi beserta planet-planet lainnya yang mengelilingi matahari pada lintasan melingkar.
However, the two models still have a weakness, namely there is no alignment between the trajectories and orbits of the planets	Namun kedua model tersebut masih memiliki kekurangan yaitu tidak ada keselarasan antara lintasan dan orbit planet
In 1609 Kepler discovered a more suitable orbital shape, namely an ellipse instead of a circle and explained it in three Kepler's Laws.	Pada tahun 1609 Kepler menemukan bentuk orbit yang lebih cocok yaitu berbentuk elips bukan lingkaran dan menjelasakannya dalam tiga Hukum Kepler
Kepler's First Law This law describes the shape of the orbital trajectories of the planets moving around the sun	Hukum I Kepler Hukum ini menjelaskan bentuk lintasan orbit planet-planet yang bergerak mengelilingi matahari
The shape of an orbital ellipse is determined by the eccentricity (e) of the ellipse, the greater the eccentricity, the longer and thinner the ellipse will be.	Bentuk elips orbit ditentukan oleh nilai eksentrisitas (e) elips, semakin besar eksentrisitasnya maka bentuk elips akan semakin memanjang dan tipis.
the smaller the eccentricity, the ellipse will be closer to the circle shape	semakin kecil eksentrisitasnya maka bentuk elipsnya akan mendekati bentuk lingkaran
The eccentricity of an ellipse is greater than 0 and less than 1	Nilai eksentrisitas elips yaitu lebih besar dari 0 dan lebih kecil dari 1
Kepler's Second Law This law explains that the orbital speed of a planet will be slower when the planet is at its farthest point from the sun (aphelion point)	Hukum II Kepler Hukum ini menjelaskan bahwa kecepatan orbit suatu planet akan lebih lambat ketika planet berada pada titik terjauh dari matahari (titik aphelion)
the maximum orbital speed of the planet when it is at the perihelion point and the minimum orbital speed of the planet when it is at the aphelion point.	kecepatan orbit maksimum planet ketika berada di titik perihelion dan kecepatan orbit minimum planet ketika berada di titik aphelion.
Kepler's Third Law This law describes the period of revolution of the planets around the sun	Hukum III Kepler Hukum ini menjelaskan periode revolusi planet-planet yang mengelilingi matahari
Planets have a longer orbital period when the planet is far from the sun and planets have a shorter orbital period when the planet is closer to the sun.	Planet memiliki periode orbit yang lebih panjang ketika planet tersebut letaknya jauh dari matahari dan planet memiliki periode orbit yang lebih pendek ketika planet tersebut letaknya dekat dari matahari.
The orbital speed of a planet will be faster when the planet is at its closest point to the sun (point of perihelion).	Kecepatan orbit suatu planet akan lebih cepat ketika planet berada pada titik terdekat dengan matahari (titik perihelion).
Each planet moves so that an imaginary line drawn from the sun to the planet covers a large area	Setiap planet bergerak sehingga suatu garis khayal yang ditarik dari matahari ke planet mencakup daerah yang luas
Each planet moves around the sun in an ellipse-shaped path and the sun is located at a focal point	Setiap planet bergerak mengelilingi matahari dalam lintasan berbentuk elips dan matahari terletak pada sutu titik fokus
In Newton's law 2 and law 1, it is explained that if an object is given a force, it will move places	Dalam hukum 2 dan hukum 1 Newton, dijelaskan bahwa jika sebuah benda diberi gaya maka benda tersebut akan berpindah tempat
The greater the force exerted, will determine how far the object moves and the object will try to maintain its position	Semakin besar gaya yang diberikan, akan menentukan seberapa jauh benda bergerak dan benda akan berusaha memepertahankan posisinya
An object that is at rest will remain at rest, and one that is moving in a straight order will move in an orderly direction.	Benda yang diam akan tetap diam, dan yang bergerak lurus beraturan akan bergerak lurus beraturan.
The forces of action and reaction of two objects have the same magnitude, reverse direction, and are linear	Gaya aksi dan reaksi dari dua benda memiliki besar yang sama, dengan arah terbalik, dan segaris
If there is object A which exerts a force of F on object B, then object B will exert a force of –F on object A	Jika ada benda A yang memberi gaya sebesar F pada benda B, maka benda B akan memberi gaya sebesar –F kepada benda A
This law is also known as the law of action-reaction, where F is called action and -F is the reaction	Hukum ini juga terkenal sebagai hukum aksi-reaksi, dengan F disebut sebagai aksi dan –F adalah reaksinya
Newton's 3rd law explains that if an object gets a force, then the object will send the force in the opposite direction with the same force to the source of the force	hukum 3 Newton menjelaskan bahwa jika suatu benda mendapatkan sebuah gaya, maka benda tersebut akan mengirimkan gaya yang berlawanan arah dengan kekuatan yang sama besar kepada sumber gaya tersebut
Law 3 has the following conditions: the magnitude of the force is the same, the direction is opposite, and works on different objects	hukum 3 ini mempunyai syarat sebagai berikut: besar gayanya sama, arahnya berlawanan, dan bekerja pada benda yang berbeda
When we run the car, the car tires will rotate in the opposite direction to the motion of the car.	Pada saat kita menjalankan mobil, maka ban mobil akan berputar berlawanan arah dengan gerak mobil.
Where the motion of a car tire is F (action) and the direction of movement of the car is F (reaction)	Dimana gerak ban mobil adalah F(aksi) dan arah gerakan mobil adalah F(reaksi)
The tire rotates slowly clockwise, creating a backward thrust so that it can propel the car	Ban yang berputar secara perlahan searah jarum jam, membuat sebuah tenaga dorongan ke belakang hingga dapat melajukan mobil
When we shoot, the gunpowder will explode and send energy forward to shoot bullets	Ketika kita menembak, mesiu akan meledak dan mengirim energi ke depan untuk menembakkan peluru
The jolt of the weapon / recoil of the weapon felt by the shooter is the reaction force produced by the bullet	Sentakan senjata/recoil senjata yang dirasakan oleh penembak adalah gaya reaksi yang dihasilkan oleh peluru tersebut
parabolic motion is a combination of regular straight motion (GLB) on the x-axis (horizontal) and regular-changing straight motion (GLBB) on the y-axis (vertical)	gerak parabola merupakan gabungan dari gerak lurus beraturan (GLB) pada sumbu x (horizontal) dan gerak lurus berubah beraturan (GLBB) pada sumbu y (vertikal)
The maximum height is reached when the object reaches its highest point on the y-axis	Ketinggian maksimum dicapai pada saat benda mencapai titik tertinggi pada sumbu y
Vertical motion is the motion of an object thrown perpendicularly downwards or upwards with a certain initial velocity (V0 ≠ 0)	Gerak vertikal adalah gerak suatu benda yang dilempar tegak lurus ke bawah atau ke atas dengan kecepatan awal tertentu (V0 ≠ 0)
Vertical motion has a constant (constant) acceleration which is the same as the acceleration due to gravity (g)	Gerak vertikal memiliki percepatan konstan (tetap) yang nilainya sama dengan percepatan gravitasi bumi (g)
Upward vertical motion is the motion of an object thrown perpendicularly upwards with a certain initial velocity (V0 ≠ 0)	Gerak vertikal ke atas adalah gerak suatu benda yang dilempar tegak lurus ke atas dengan kecepatan awal tertentu (V0 ≠ 0)
This initial velocity will affect the maximum height that the object can travel	Kecepatan awal ini akan mempengaruhi tinggi maksimum yang dapat ditempuh oleh benda tersebut
The greater the initial velocity, the higher the maximum altitude	Semakin besar kecepatan awalnya, maka semakin tinggi pula ketinggian maksimumnya
Upward vertical motion is slowed down because the higher it is, the speed decreases	Gerak vertikal ke atas merupakan gerak diperlambat karena semakin ke atas, kecepatannya akan semakin berkurang
The object's velocity will continue to decrease until it reaches zero, which is the highest point	Kecepatan benda akan terus berkurang sampai mencapai titik nol, yaitu pada titik tertinggi
downward vertical motion is the motion of an object thrown downright with a certain initial velocity (V0 ≠ 0).	gerak vertikal ke bawah adalah gerak suatu benda yang dilempar tegak lurus ke bawah dengan kecepatan awal tertentu (V0 ≠ 0).
If the direction of the motion is downward, then a = g because it is in the same direction as Earth's gravity and the object is accelerating	Jika arah geraknya ke bawah, maka a = g karena searah dengan gravitasi bumi dan benda mengalami percepatan
In 1889, scientists from various countries gathered in London to discuss the standardization of mass measurements.	Pada 1889, ilmuwan dari berbagai negara berkumpul di London buat ngomongin standarisasi ukuran massa.
they agreed to make an object measuring 4 cm with a composition of 90% platinum and 10% iridium and were given the name Big K	mereka sepakat untuk bikin benda berukuran 4 cm dengan komposisi 90% platinum dan 10% iridium dan dikasih nama K Besar
They held a General Conference on Weights and Measures (CGPM) conference to redefine the kilogram weight	Mereka mengadakan konferensi General Conference on Weights and Measures (CGPM) untuk mendefinisikan ulang berat kilogram
The New York Times explains that the units of seconds and meters have experienced a similar thing, in 1967 and 1983	The New York Times menjelaskan kalau satuan detik dan meter juga pernah mengalami hal serupa, tahun 1967 dan 1983
The unit of meter length is measured by the universal constant of the speed of light. 1 meter is defined as the distance traveled by a laser beam in a vacuum in the speed of 1 / 299,792,458 second	Satuan panjang meter diukur dengan konstanta universal kecepatan cahaya. 1 meter didefinisikan sebagai jarak yang ditempuh sinar laser di ruang hampa dalam kecepatan 1/299,792,458 detik
Meanwhile, seconds is defined as the amount of time it takes for the cesium-133 atom to vibrate 9,192,631,770 times	Sementara detik diartikan sebagai jumlah waktu yang dibutuhkan atom cesium-133 untuk bergetar 9.192.631.770 kali
The resultant of a vector is the sum of two or more vectors	Resultan vektor adalah hasil dari penjumlahan dua atau lebih vektor
There are several methods that we can use to find vector resultants including the graphic method, the vector analysis method, or the description method.	Terdapat beberapa metode yang bisa kita gunakan untuk mencari resultan vektor di antaranya metode grafis, metode analisis vektor, atau metode uraian.
The graphic method is a method used to determine the magnitude of the resultant vector by measuring it	Metode grafis adalah metode yang digunakan untuk menentukan besar resultan vektor dengan cara mengukurnya
The length of the resultant vector can be measured using a ruler (ruler), while the angle of the vector (vector direction) is measured using a protractor	Panjang resultan vektor dapat diukur menggunakan mistar (penggaris), sedangkan besar sudut vektor (arah vektor) diukur menggunakan busur derajat
The measurement of the resultant vector size using a graphic method must be based on the correct scale and angle	Pengukuran besar resultan vektor menggunakan metode grafis harus berdasarkan skala dan besar sudut yang tepat
The analytical method is a method used to determine the resultant vector mathematically using a formula.	Metode analitis adalah metode yang digunakan untuk menentukan besar resultan vektor secara matematis dengan menggunakan rumus.
The formula used is the cosine (cos) formula to determine the magnitude of the resultant vector and the sine formula (sin) to determine the direction of the resultant vector.	Rumus yang digunakan merupakan rumus cosinus (cos) untuk menentukan besar resultan vektor dan rumus sinus (sin) untuk menentukan arah resultan vektor.
The description method, first decompose the vectors into vector components on the x-axis and vector components on the y-axis in Cartesian coordinates.	Metode uraian, uraikan terlebih dahulu vektor-vektor tersebut menjadi komponen vektor pada sumbu x dan komponen vektor pada sumbu y di koordinat kartesius
a vector will always be positive. In addition, in determining the direction of the vector, we must pay attention to the Ax and Ay signs which will determine the quadrant of the vector in the coordinating system.	suatu vektor akan selalu bernilai positif. Selain itu, dalam menentukan arah vektor, kita harus memperhatikan tanda Ax dan Ay yang nantinya akan menentukan kuadran dari vektor dalam sistem koordinatraikan
The use of the graphical method in calculating the number of two or more vectors has a weakness, that is, it can cause systematic errors.	Penggunaan metode grafis dalam menghitung jumlah dua atau lebih vektor ternyata memiliki kelemahan, yaitu dapat menimbulkan kesalahan sistematis.
Even though we couldn’t go anywhere in this pandemic, at least the moment we had together was enough	Meskipun kami tidak bisa pergi kemana-mana saat pandemi ini, setidaknya momen yang kami miliki bersama sudah cukup
We eventually enjoyed our time grilling beef and other foods	Kami akhirnya menikmati waktu kami memanggang daging sapi dan makanan lainnya
I hope the pandemic end soon and we can go outside without worrying about anything. 	Aku berharap pandemi segera berakhir dan kita bisa keluar tanpa khawatir tentang apapun.
I was laying in my bed when suddenly an idea came into my mind 	Aku sedang berbaring di tempat tidur ketika tiba-tiba sebuah ide muncul di benakku
I watched some knitting videos for the beginners on the internet and I really wanted to try it by myself.	Aku menonton beberapa video merajut untuk pemula di internet dan aku sangat ingin mencobanya sendiri.
I was more grateful since I still had a chance to spend a great time in my holiday.	aku lebih bersyukur karena aku masih memiliki kesempatan untuk menghabiskan waktu yang menyenangkan di hari liburku
My friend bought a cellphone that was just released in an online shop	Teman saya membeli handphone yang baru rilis di toko online 
Mother and father went grocery shopping to the market on motorbikes	Ibu dan ayah pergi belanja bahan makanan ke pasar menggunakan motor
My friends really like playing games at the Aming café	Teman - teman saya sangat suka bermain game di caffe Aming 
I studied at the University of TanjungPura Pontianak and now I am in 6th semester	Saya berkuliah di Universitas TanjungPura Pontianak dan sekarang saya sudah semester 6
My friend is going to the mall tonight to buy shoes	Teman saya akan pergi ke mall malam ini untuk membeli sepatu 
Humans need at least 2 liters of water a day to meet their water needs	Manusia memerlukan setidaknya 2 liter air sehari agar memenuhi kebutuhan air
Using a cellphone for too long can damage the eyes and interfere with health	Menggunakan handphone terlalu lama dapat merusak mata dan mengganggu kesehatan
In this day and age, everyone is required to understand technology	Di zaman sekarang semua orang dituntut sudah harus mengerti teknologi
His father and friends went fishing from morning to night	Ayah dan temannya pergi memancing dari pagi sampai malam hari
Today Adi is wearing a dark blue shirt and pants	Hari ini Adi menggunakan baju dan celana berwarna biru tua
On campus I have very nice and friendly lecturers	Di kampus saya memiliki dosen yang sangat baik dan ramah
During the Covid 19 pandemic, we must wear masks when leaving the house	Di masa pandemi covid 19 ini kita wajib menggunakan masker saat keluar rumah
During the Covid 19 pandemic, we must wash our hands after leaving the house	Di masa pandemi covid 19 ini kita wajib mencuci tangan setelah keluar rumah
At that time there was also someone who advised me that God always gives the burden of problems according to the ability of each person	Saat itu juga ada yang menasehati aku bahwa Tuhan selalu memberikan beban masalah sesuai dengan kemampuan masing-masing orang
Therefore the response from people is also different, sometimes some feel burdened there are also those who do not	Oleh karena itu respon dari orang-orang pun juga berbeda-beda, terkadang ada yang merasa dibebani ada juga yang tidak
God knows how strong we are to be able to deal with the problems given by Him	Tuhan tahu seberapa kuat kita untuk bisa menghadapi masalah yang diberikan oleh-Nya
Therefore if the question of portion should not be asked yes, because we know that God is indeed Just	Maka dari itu kalau soal porsi jangan ditanyakan ya, karena kita tahu kalau Tuhan itu memang Maha Adil
During the Covid 19 pandemic, many people lost their jobs	Di masa pandemi covid 19 ini banyak orang yang kehilangan pekerjaan
During the Covid 19 pandemic, schools, campuses and offices were closed	Di masa pandemi covid 19 ini sekolah, kampus, dan kantor di tutup
The total number of cases exposed to Covid 19 in Indonesia is 1.51 million cases	Total kasus terpapar covid 19 di indonesia sudah 1,51jt kasus
The total number of cases of death due to Covid 19 in Indonesia has been 40,754 cases	Total kasus kematian dikarenakan covid 19 di indonesia sudah 40.754 kasus
The total who has recovered from Covid 19 in Indonesia is 1.34 million	Total yang telah sembuh dari  covid 19 di indonesia sudah 1,34jt 
Covid 19 cases in Pontianak are quite high, namely as many as 1323 cases	Kasus covid 19 di pontianak cukup tinggi yaitu sebanyak 1323 kasus
The government provided assistance to residents during the covid pandemic 19	Pemerintah memberikan bantuan kepada warga selama masa pandemi covid 19
The government provides study quota assistance to students and students during	Pemerintah memberikan bantuan kuota belajar kepada Siswa dan mahasiswa selama
During this time of the pandemic, all students and university students are now studying online	Selama masa pandemi ini, semua siswa dan mahasiswa sekarang belajar online 
The Covid 19 vaccine has been found and now the whole world has used it	Vaksin Covid 19 telah ditemukan dan kini seluruh dunia menggunakannya
President Joko Widodo was the first to use the Covid 19 vaccine in Indonesia	Presiden joko widodo adalah orang yang pertama menggunakan vaksin Covid 19 di indonesia
It doesn't feel like it has been almost 1 year of the Covid 19 pandemic	Tidak terasa sudah hampir 1 tahun pandemi covid 19 ini berlangsung
Citrus fruits are very good for the body because they contain lots of vitamin c	Buah jeruk sangat baik untuk tubuh karena banyak mengandung vitamin c
Coconut water has many benefits, one of which is to increase endurance	Air Kelapa sangat banyak manfaatnya salah satunya untuk meningkatkan daya tahan tubuh
Fruit is one food that is very good for the body because it contains many vitamins	Buah adalah salah satu makanan yang sangat baik bagi tubuh karena banyak menggandung vitamin
Grapes are a great source of the nutrient vitamin C and powerful antioxidants.	Buah anggur adalah sumber nutrisi vitamin C dan antioksidan kuat
Grapes have various colors such as green, red, and black	Buah anggur memiliki macam - macam warna seperti hijau,merah, dan hitam
Many people love apples because of their sweet and refreshing taste	Banyak orang yang menyukai apel karena rasanya yang manis dan menyegarkan
Apples contain calories, carbohydrates, fiber, vitamin C, and much more	Apel mengandung kalori, karbohidrat, serat, vitamin C, dan masih banyak lagi
The benefits of avocado are a source of vitamins C, E, K, B-6, and many more	Manfaat alpukat adalah menjadi sumber vitamin C, E, K,B-6,dan masih banyak lagi
You can get calcium, vitamin D, and even vitamin K from avocados.	Anda bisa mendapatkan asupan kalsium, vitamin D, bahkan vitamin K dari alpukat.
Soursop, fruit with white flesh that is sweet and slightly sour	Sirsak, buah dengan daging berwarna putih yang manis dan sedikit asam
Soursop contains many vitamins and minerals that our bodies need	Sirsak mengandung banyak vitamin dan mineral yang dibutuhkan tubuh kita
Watermelon is known to have a high water content and has always been a favorite of many people	Buah semangka terkenal memiliki kandungan air yang tinggi dan selalu menjadi favorit banyak orang
Watermelon Has Vitamin A, vitamin C, vitamin B6, lycopene, antioxidants and amino acids.	Semangka Memiliki Vitamin A, vitamin C, vitamin B6, likopen, antioksidan dan juga asam amino.
I'm leaving Pontianak and going to Jakarta tomorrow morning	Saya akan meninggalkan Pontianak dan akan ke Jakarta besok pagi
The flag ceremony is carried out every Monday morning in the school yard	Upacara bendera dilakukan setiap hari senin pagi di halaman sekolah
The flag ceremony is held every Monday morning in the courtyard of the governor's office	Upacara bendera dilakukan setiap hari senin pagi di halaman kantor gubernur
Now students and students only study from Monday to Friday	Sekarang murid dan mahasiswa hanya belajar dari hari senin sampai hari jumat
English lessons are very much liked by Andi and his classmates	Pelajaran bahasa inggris sangat disukai oleh andi dan teman kelasnya
Andi and his classmates disliked counting lessons	Pelajaran menghitung sangat tidak disukai oleh andi dan teman kelasnya
Fire is a fast oxidation of a material in a chemical combustion process	Api merupakan oksidasi yang cepat terhadap suatu material dalam proses pembakaran kimiawi
The hottest flames are in the core of the sun, arising from a fusion reaction by the sun	Api yang paling panas berada di dalam inti matahari, muncul akibat adanya reaksi fusi oleh matahari
white fire is widely used in factories that produce iron and similar materials.	api putih banyak dipakai di pabrik-pabrik yang memproduksi material besi dan bahan sejenisnya
Blue fire has a temperature of about 1500 degrees Celsius, maybe this fire we often encounter.	Api biru mempunyai suhu sekitar 1500 derajat celcius, mungkin api ini sering kita jumpai.
The blue fire is gas-fired and experiences complete combustion.	Api biru berbahan bakar gas serta mengalami pembakaran yang sempurna.
Red fire has a temperature of around 1200 to 1500 degrees Celsius	Api merah mempunyai suhu sekitar 1200 sampai 1500 derajat celcius
We often encounter orange flames at burning wood or charcoal	Api berwarna jingga sering kita jumpai pada pembakaran kayu atau arang
The temperature of an orange fire is in the range 1000 to 1200 degrees Celsius	Api berwarna jingga suhunya berada di kisaran 1000 sampai 1200 derajat celcius
The fire is red.The temperature is below 1000 degrees Celsius.	Api berwarna merah Suhunya berada di bawah 1000 derajat celcius. 
The red fire is usually found at the outermost part of the flame	Api merah biasanya kita temui di bagian paling luar dari nyala api
Water is an essential compound for all known forms of life on Earth	Air adalah senyawa yang penting bagi semua bentuk kehidupan yang diketahui sampai saat ini di Bumi
Water covers nearly 71% of the Earth's surface. There are 1.4 trillion cubic kilometers of water in the world	Air menutupi hampir 71% permukaan Bumi Terdapat 1,4 triliun kilometer kubik air di dunia
The chemical formula for water is H2O, each molecule containing one oxygen and two hydrogen atoms	Rumus kimia air adalah H2O, yang setiap molekulnya mengandung satu oksigen dan dua atom hidrogen 
To get fresh water from sea water can be done by reverse osmosis	Untuk mendapatkan air tawar dari air laut bisa dilakukan dengan cara osmosis terbalik
Water vapor is water in the form of a gas which occurs as a result of the heating process of water (H2O) to become water vapor	Uap air adalah air yang dalam bentuk gas yang terjadi akibat proses pemanasan air (H2O) menjadi uap air
Water vapor is used to drive PLTU electric turbines, steam trains, or steam engines.	Uap air digunakan untuk menggerakkan turbin listrik PLTU, kereta uap, atau mesin uap.
The sun formed about 4.6 billion years ago as a result of the gravitational decay of a region	Matahari terbentuk sekitar 4,6 miliar tahun yang lalu akibat peluruhan gravitasi suatu wilayah 
Paper is a thin material, which is produced by compression of the fibers that come from the pulp.	Kertas adalah bahan yang tipis, yang dihasilkan dengan kompresi serat yang berasal dari pulp.
The paper fibers used are usually natural, and contain cellulose and hemicellulose	Serat kertas yang digunakan biasanya adalah alami, dan mengandung selulosa dan hemiselulosa
Paper is known as the main medium for writing, printing and painting and many other uses	Kertas dikenal sebagai media utama untuk menulis, mencetak serta melukis dan banyak kegunaan lain
In Indonesia, the first paper that has been made in Ponorogo since the 7th century is made of bark	Di Indonesia, kertas pertama kali telah di buat di Ponorogo sejak abad ke-7 yang terbuat dari kulit kayu
A pencil is a writing and painting tool that was originally made of pure graphite	Pensil adalah alat tulis dan lukis yang awalnya terbuat dari grafit murni
Modern pencils are made by crushing pure graphite and clay into powder form.	Pensil di era modern dibuat dengan menghancurkan grafit murni dan tanah liat menjadi bentuk bubuk.
Plastics are formed from organic condensation or addition of polymers and may also consist of other substances	Plastik terbentuk dari kondensasi organik atau penambahan polimer dan bisa juga terdiri dari zat lain
Language is the ability that humans have to communicate with other humans	Bahasa adalah kemampuan yang dimiliki manusia untuk berkomunikasi dengan manusia lainnya
Human language is unique in that it has productivity, recursive, and shifting properties.	Bahasa manusia unik karena memiliki sifat-sifat produktivitas, rekursif, dan pergeseran.
Java was developed in 1990 by Sun engineer James Gosling as a programming language	Java dikembangkan pada tahun 1990 oleh insinyur Sun, James Gosling sebagai bahasa pemrograman
Java is a programming language that is concurrent, class-based, and object-oriented	Java adalah bahasa pemrograman yang concurrent, berbasis kelas, dan berorientasi objek
C language was developed at Bell lab in 1972 written first by Brian W.	Bahasa C dikembangken di Bell lab pada tahun 1972 ditulis pertama kali oleh Brian W
The C language was originally designed as a programming language that runs on the UNIX operating system.	Bahasa C pada awalnya dirancang sebagai bahasa pemrograman yang dioperasikan pada sistem operasi UNIX.
The language C ++ was born in 1980, created by Bjarne Stroustrup at AT&T Bell Laboratories	Bahasa C++ lahir pada tahun 1980, yang dibuat oleh Bjarne Stroustrup di AT&T Bell Laboratories
Python is a programming language that can execute a number of multi-use instructions	Python adalah salah satu bahasa pemrograman yang dapat melakukan eksekusi sejumlah instruksi multi guna 
Python itself features interesting features so it's worth learning.	Python sendiri menampilkan fitur-fitur menarik sehingga layak untuk Anda pelajari.
Python was created and developed by Guido Van Rossum, a programmer from the Netherlands.	Python dibuat dan dikembangkan oleh Guido Van Rossum, yaitu seorang programmer yang berasal dari Belanda.
Many people are interested in using Python because it is considered easy to learn	Banyak orang yang tertarik untuk menggunakan Python karena dianggap mudah untuk dipelajari
Microsoft created Windows 1.0 This name comes from Microsoft's employee slum	Microsoft menciptakan Windows 1.0 Nama ini berasal dari kelatahan karyawan Microsoft
Windows version 2 is the first version of Windows that can be installed programs	Windows versi 2 adalah versi Windows pertama yang bisa diinstal program
Windows version 3.1 is a version of Windows that can optimize its use on 32-bit processors	Windows versi 3.1 adalah versi Windows yang bisa mengoptimalisasi penggunaannya pada prosesor 32-bit
Windows was first launched in 1985. Pioneered by Bill Gates	Pertama kali windows diluncurkan pada tahun 1985. Yang dipelopori oleh Bill Gates
Microsoft was founded to develop and sell BASIC translators for the Altair 8800.	Microsoft didirikan untuk mengembangkan dan menjual penerjemah BASIC untuk Altair 8800.
In 2012, Microsoft is dominating the PC operating system market and the office software market	Tahun 2012, Microsoft adalah mendominasi pasar sistem operasi PC dan pasar perangkat lunak perkantoran
Apple Inc. is a multinational technology company headquartered in Cupertino, California	Apple Inc. adalah perusahaan teknologi multinasional yang berpusat di Cupertino, California
Apple was founded by Steve Jobs, Steve Wozniak, and Ronald Wayne in April 1976	Apple didirikan oleh Steve Jobs, Steve Wozniak, dan Ronald Wayne pada April 1976 
Apple I is the first computer invention made from scratch by Wozniak	Apple I merupakan penemuan komputer pertama yang dibuat dari awal oleh Wozniak
In 1977, Wozniak built the next computer as a second product, the Apple II	Pada tahun 1977, Wozniak membangun komputer berikutnya sebagai produk kedua, yaitu Apple II
In 1980, Apple III was released and put on the market	Pada tahun 1980, Apple III telah dikeluarkan dan dimasukkan ke pasar 
Swimming is a sport that is done in water	Renang merupakan salah satu cabang olahraga yang dilakukan di dalam air
Swimming sports are healthy and have benefits for the body	Renang olahraga yang menyehatkan dan memiliki manfaat bagi tubuh
The internet started in 1969 and at that time the internet was just a computer network	Internet berawal pada tahun 1969 dan pada saat itu internet hanyalah sebuah jaringan komputer 
The first generation of computers began when computers were used in academics and the military,	Komputer generasi pertama dimulai ketika komputer digunakan dalam akademik dan militer,
The second generation of computers started when the transistor replaced the vacuum tube.	Komputer Generasi kedua dimulai ketika transistor menggantikan tabung vakum.
The third generation computers started when transistor technology was upgraded to integrated circuits.	Komputer Generasi ketiga dimulai ketika teknologi transistor meningkat menjadi sirkuit terpadu.
Mbok Srini can only wait for the miracle to be able to have children	Mbok Srini hanya dapat menunggu keajaiban untuk bisa memiliki anak
He wished for miracles to happen to him, by always praying day and night to Almighty God so that he could be given a child	Ia berharap keajaiban terjadi padanya, dengan selalu berdoa siang dan malam kepada Tuhan Yang Mahakuasa agar dapat diberikan anak
In his dream, came a giant who told him to take a parcel under a pesar tree in the forest	Dalam mimpinya, datang raksasa yang menyuruhnya mengambil bungkusan di bawah pohon pesar di hutan
Mbok Srini was approached by a giant who told her to go get a parcel under a large tree	Mbok Srini didatangi sesosok raksasa yang menyuruhnya pergi mengambil sebuah bungkusan di bawah pohon besar
When she woke up in the morning, Mbok Srini could barely believe her dream last night	Saat terbangun di pagi hari, Mbok Srini hampir tidak percaya dengan mimpinya semalam
Romance is a type of story poetry that uses romantic language which contains stories of love, interspersed with fights and adventures	 Romansa adalah jenis puisi cerita yang menggunakan bahasa romantik yang berisi kisah percintaan, yang diselingi perkelahian dan petualangan
Descriptive Poetry In this type of poetry, the poet acts as an impressionist on the situation / event, object, or atmosphere that is seen to attract his attention.	Puisi Deskriptif Dalam jenis puisi ini, penyair bertindak sebagai pemberi kesan terhadap keadaan/peristiwa, benda, atau suasana yang dipandang menarik perhatiannya. 
Satire is a poem that expresses the poet's feelings of dissatisfaction with a situation, but in a satirical way or states the opposite.	Satire adalah puisi yang mengungkapkan perasaan ketidakpuasan penyair terhadap suatu keadaan, namun dengan cara menyindir atau menyatakan keadaan sebaliknya.
Social critical poetry is poetry which also expresses the poet's dissatisfaction with one's situation or self,	Puisi kritik sosial adalah puisi yang juga menyatakan ketidakpuasan penyair terhadap keadaan atau terhadap diri seseorang, 
Elegi is a poem that expresses feelings of sorrow. For example Elegi Jakarta by Asrul Sani which expresses the feeling of sorrow of poets in the city of Jakarta.	Elegi adalah puisi yang mengungkapkan perasaan duka. Misalnya Elegi Jakarta karya Asrul Sani yang mengungkapkan perasaan duka penyair di Kota Jakarta.
the deepest ocean that humans have ever measured is about 10.9 km	laut paling dalam yang pernah diukur manusia itu sekitar 10,9 km
The ocean also holds many mysteries, for example, living things that have never been found before	Lautan juga menyimpan banyak misteri, misalnya makhluk hidup yang belum pernah ditemukan sebelumnya
natural and mineral resources, or even man-made objects that fall into the ocean, such as ships or planes	sumber daya alam dan mineral, atau bahkan benda buatan manusia yang jatuh kelautan, seperti kapal laut atau pesawat
To unravel all these mysteries, we need a picture of the underwater surface	untuk mengungkap semua misteri tadi, kita butuh sebuah gambaran tentang permukaan bawah air
We can build technology based on physical phenomena. All of that take advantage of the sound wave phenomenon	Kita bisa membangun teknologi berdasarkan fenomena fisika. Semua itu memanfaatkan fenomena gelombang bunyi 
Ultrasonic frequency is more than 20,000Hz, these waves can propagate and spread in seawater	ultrasonik itu frekuensinya lebih dari 20.000Hz, gelombang ini dapat merambat dan menjalar pada air laut
By studying the movement of these sound waves, we can predict the existence of objects on the ocean floor	Dengan mempelajari pergerakan gelombang bunyi ini, kita bisa loh memprediksi keberadaan benda-benda di dasar laut
technology that uses an ultrasonic method like this is called sonar or sound navigation and ranging	teknologi yang memakai metode ultrasonik seperti ini bernama sonar atau sound navigation and ranging
Sonar (Sound Navigation and Ranging) is a device system for detecting and determining the distance of objects that are under the sea.	Sonar (Sound Navigation and Ranging) adalah sistem perangkat untuk mendeteksi dan menentukan jarak benda yang ada di bawah laut.
These other sound waves cannot travel very far in the water. Meanwhile, ultrasonic sound waves have the unique ability to propagate over long distances.	 gelombang suara yang lain ini tidak bisa merambat jauh di dalam air. Sedangkan gelombang suara ultrasonik ini memiliki kemampuan unik untuk merambat dalam jarak yang jauh.
Sonar was first used to detect underwater icebergs. Then, it is also used in the military to find out enemy submarines and mines	Sonar pertama kali dipakai untuk mendeteksi gunung es di bawah laut. Terus, dipakai juga di bidang militer untuk cari tahu kapal selam musuh dan ranjau
Until now, sonar is still used mainly to find lost objects in the sea and to measure the depth of the ocean	Sampai sekarang, sonar masih sering dipakai terutama untuk menemukan benda hilang di laut, dan untuk mengukur kedalaman laut
Passive sonar is a sonar system that was made for the first time.Passive sonar systems are simpler than active sonar systems because they do not send signals or sound waves	Sonar pasif adalah sistem sonar yang dibuat pertama kali Sistem sonar pasif lebih sederhana dari sistem sonar aktif karena dia nggak mengirim sinyal atau gelombang suara
Passive sonar can only detect sound waves coming towards the ship's receiver or operator and the results can be seen on the monitor screen	Sonar pasif cuma bisa mendeteksi gelombang suara yang datang ke arah penerima atau operator kapal dan hasilnya bisa dilihat di layar monitor
Passive sonar tends not to be able to measure object distances and ocean depths	sonar pasif cenderung nggak bisa mengukur jarak objek dan kedalaman laut
Examples of active sonar systems include multibeam, side scan sonar (sss), split-beam, matess or mine detection sonar systems, etc.	Contoh dari sistem sonar aktif ada multibeam, side scan sonar (sss), split-beam, matess atau mine detection sonar system, dll.
The way the ship's active sonar works is to send a sound wave transmitter into the water using a device called a sonar transducer	Cara kerja sonar aktif kapal mengirim pemancar (transmitter) gelombang suara ke dalam air pakai alat bernama transduser sonar
Sound waves propagate in the water and will later hit target objects such as animals, objects under the sea, and the ocean floor	Gelombang suara merambat di air dan nanti akan mengenai objek sasaran kayak misalnya hewan, benda yang ada di bawah laut, dan dasar lautan
When hitting the target object, the sound reflection will produce an echo effect	Saat kena objek sasaran, pantulan suara itu akan menghasilkan efek gema atau echo
We can directly analyze it on the monitor for data purposes such as direction, wave velocity, and time	Kita bisa langsung dianalisis di monitor untuk keperluan data kayak arah, cepat rambat gelombang, dan waktu
However, because the distance between the ultrasonic sound waves in the sea goes back and forth (incoming and reflected sound waves), it must be divided by 2.	Tapi, karena jarak gelombang suara ultrasonik di laut itu bolak-balik (gelombang suara datang dan pantul) makanya harus dibagi 2.
Sound Waves are waves that propagate through a particular medium. Sound waves are mechanical waves classified as longitudinal waves.	Gelombang Bunyi adalah gelombang yang merambat melalui medium tertentu. Gelombang bunyi merupakan gelombang mekanik yang digolongkan sebagai gelombang longitudinal.
Audiosonics, sound waves that have a frequency between 20-20,000 Hz. This frequency can be heard by the human ear.	Audiosonik, gelombang bunyi yang memiliki frekuensi antara 20--20.000 Hz. Frekuensi inilah yang dapat didengar oleh telinga manusia.
Ultrasonic, sound waves having a frequency of> 20,000 Hz. The animals that can hear these sound waves are dogs and bats.	Ultrasonik, gelombang bunyi yang memiliki frekuensi > 20.000 Hz. Hewan yang dapat mendengar gelombang bunyi ini ialah anjing dan kelelawar.
Sound waves travel at a certain speed. The speed of sound varies from 330 m / s to 5,400 m / s.	Gelombang bunyi merambat dengan kecepatan tertentu. Kecepatan bunyi bervariasi antara 330 m/s hingga 5.400 m/s.
The speed of sound propagation in a solid depends on the Young modulus (E) and the density or density of the solid.	Cepat rambat bunyi dalam suatu zat padat bergantung pada modulus Young (E) dan kerapatan atau massa jenis dari zat padat tersebut.
The speed of sound propagation depends on the medium in which the sound is located. In air, the speed of sound depends on the temperature of the air and the types of particles that make up the air	Cepat rambat bunyi bergantung pada medium letak bunyi tersebut berada. Di udara, kecepatan bunyi bergantung pada suhu udara dan jenis-jenis partikel yang menyusun udara tersebut
The speed of sound propagation in a liquid depends on the Bulk modulus (B) and the density or density of the substance.	Cepat rambat bunyi dalam zat cair bergantung pada modulus Bulk (B) dan kerapatan atau massa jenis dari zat tersebut.
A traveling wave is a wave whose amplitude and phase are fixed at each point in its path	Gelombang berjalan adalah gelombang yang amplitudo dan fasenya tetap pada setiap titik yang dilewatinya
A standing wave or stationary wave is a wave whose amplitude varies, the value starts from zero to reach a certain maximum value	Gelombang berdiri atau gelombang stasioner merupakan gelombang yang amplitudonya berubah-ubah, nilainya mulai dari nol hingga mencapai nilai maksimum tertentu
An example of a walking wave event in everyday life is a rope, one end of which is tied to a pole and the other end is moved up and down.	Contoh peristiwa gelombang berjalan dalam kehidupan sehari-hari yaitu pada seutas tali yang salah satu ujungnya diikatkan ke suatu tiang dan ujung lainnya digerakkan ke atas dan ke bawah
The wave of the rope will travel from the end of the rope which is vibrated to the end of the rope that is tied, then it will be reflected back in its original direction.	Gelombang tali akan merambat dari ujung tali yang digetarkan ke ujung tali yang terikat, kemudian akan dipantulkan kembali ke arah semula.
I ran across a rare book in a secondhand bookstore.	Aku kebetulan menemukan sebuah buku yang langka di toko buku bekas.
I'll only buy the car if they fix the brakes first.	Aku baru akan membeli mobilnya jika mereka terlebih dahulu memperbaiki remnya.
Life in prison is worse than the life of an animal.	Hidup di penjara lebih buruk dibanding hidupnya seekor binatang.
Mother-in-law jokes are funny because they're true.	Lelucon tentang ibu tiri itu lucu karena sesuai dengan kenyataan.
A standing wave with a bonded end has a phase angle of the incident wave and the reflected wave with different radians. The tip of the reflector cannot move freely in the direction of the incident wave vibration.	Gelombang berdiri dengan ujung terikat memiliki sudut fase gelombang datang dan gelombang pantul yang berbeda besar radiannya. Ujung pemantul tidak dapat bergerak bebas mengikuti arah getar gelombang datang.
Waves are propagating vibrations, which carry energy during their propagation.	Gelombang merupakan getaran yang merambat, yang membawa energi selama perambatannya.
Transverse wave. This wave is a wave in which the direction of the intermediate medium particles is perpendicular to the direction of the wave	Gelombang transversal. Gelombang ini merupakan gelombang yang arah getar partikel medium perantaranya tegak lurus terhadap arah gelombang
Some examples of the application of these transverse waves are light waves, waves on ropes, and waves on the surface of water.	Beberapa contoh dari penerapan gelombang transversal ini adalah gelombang cahaya, gelombang pada tali, dan gelombang pada permukaan air.
Longitudinal waves. In contrast to transverse, longitudinal waves are waves in which the direction of the intermediate medium particles is parallel or coincident with the direction of propagation.	Gelombang longitudinal. Berbeda dengan transversal, gelombang longitudinal merupakan gelombang yang arah getar partikel medium perantaranya sejajar atau berhimpit dengan arah rambatannya.
for the calculation of the length of one longitudinal wave it is expressed in terms of density and strain	Untuk perhitungan panjang satu gelombang longitudinal ini dinyatakan dalam satu rapatan dan regangan 
Examples of the application of these longitudinal waves are sound waves, plasma waves, and slinki (spring) waves.	Contoh dari penerapan gelombang longitudinal ini adalah gelombang suara, gelombang plasma, dan gelombang slinki (pegas)
Different types of propagation direction, different waveforms, to the application of these waves in everyday life	Perbedaan jenis arah rambatannya, perbedaan bentuk gelombangnya, hingga penerapan gelombang ini dalam kehidupan sehari-hari
These transverse waves are composed of hills and valleys. Where in this wave, the length of one wave is expressed in 1 hill and 1 valley.	Gelombang transversal ini disusun atas bukit dan lembah. Di mana pada gelombang ini, panjang satu gelombangnya dinyatakan dalam 1 bukit dan 1 lembah.
Vibration is the movement back and forth on an object in a certain time through its equilibrium point	Getaran merupakan gerakan bolak-balik pada suatu benda dalam selang waktu tertentu melalui titik kesetimbangannya
Objects are said to vibrate in one full vibration ie from the starting point and return to that starting point	Benda dikatakan bergetar dalam satu kali getaran penuh yakni dari titik awal dan kembali ke titik awal tersebut
One full vibration is when the object moves from point A-B-C-B-A or from point C-B-A-B-C	Satu kali getaran penuh adalah saat benda bergerak dari titik A-B-C-B-A atau dari titik C-B-A-B-C
The farthest deviation is called the amplitude. If we look at the picture above, the amplitude of the pendulum is the distance BC or distance BA	Simpangan terjauh ini, disebut dengan amplitudo. Jika kita lihat pada gambar di atas, amplitudo pada bandul adalah jarak BC atau jarak BA
Waves are propagating vibrations, which carry energy during their propagation	Gelombang adalah getaran yang merambat, yang membawa energi selama perambatannya
Mechanical waves: Waves that require a medium to propagate. For example in sound waves.	Gelombang mekanik: Gelombang yang membutuhkan medium dalam perambatannya. Contohnya pada gelombang bunyi.
A person can listen to music and sound because sound waves travel through the air and reach the ears	Seseorang dapat mendengarkan musik dan suara karena gelombang bunyi merambat melalui udara sehingga sampai ke telinga
electromagnetic waves: Waves that do not require a medium to propagate. For example in light waves.	elombang elektromagnetik: Gelombang yang tidak membutuhkan medium dalam perambatannya. Contohnya pada gelombang cahaya.
Longitudinal Waves: Waves whose vibrational direction is parallel to the direction of propagation. In one longitudinal wave consists of one strain and one density.	Gelombang longitudinal: Gelombang yang arah getarannya sejajar dengan arah rambatnya. Dalam satu gelombang longitudinal terdiri dari satu regangan dan satu rapatan.
Transverse wave: Wave whose direction of vibration is perpendicular to the direction of propagation	Gelombang transversal: Gelombang yang arah getaranya tegak lurus dengan arah rambatnya
Electromagnetic waves are waves that do not require a medium in their propagation.	Gelombang elektromagnetik merupakan gelombang yang tidak membutuhkan medium dalam perambatannya.
Electromagnetic energy propagates in waves through several characteristics such as wavelength, amplitude, frequency, and velocity.	Energi elektromagnetik merambat dalam gelombang melalui beberapa karakter seperti panjang gelombang, amplitudo, frekuensi, dan kecepatan.
The higher the energy level in an energy source, the lower the wavelength of the energy produced but the higher the frequency	Semakin tinggi level energi dalam suatu sumber energi, maka semakin rendah panjang gelombang dari energi yang dihasilkan akan tetapi semakin tinggi frekuensinya
The spectrum of electromagnetic waves in the order from the largest wavelength or smallest frequency to the smallest wavelength or largest frequency	Spektrum gelombang elektromagnetik dengan urutan dari panjang gelombang terbesar atau frekuensi terkecil ke panjang gelombang terkecil atau frekuensi terbesar
Radio waves: used to transmit signals over great distances.	Gelombang radio: dimanfaatkan untuk mentransmisikan sinyal pada jarak yang sangat jauh. 
Radio waves are used by TV and radio stations to transmit communication signals, in addition to that used by radar and for satellite imagery to the earth in making 3-dimensional maps	gelombang radio dipakai oleh stasiun TV dan radio untuk mentransmisikan sinyal komunikasi, selain itu digunakan oleh radar dan untuk pencitraan satelit ke bumi dalam pembuatan peta 3 dimensi
Microwaves: when microwaves are absorbed by an object, a heating effect will appear on the object	Gelombang mikro: ketika gelombang mikro diserap oleh sebuah benda, maka akan muncul efek pemanasan pada benda tersebut
Infrared rays: infrared rays cannot be seen but can be detected above the spectrum of red light which is used to transfer energy which is not too large.	Sinar inframerah: sinar inframerah tidak dapat terlihat tetapi dapat terdeteksi diatas spektrum cahaya merah yang dipakai untuk memindahkan energi yang tidak terlalu besar.
Visible light: has an electromagnetic spectrum that can be detected by the human eye	Cahaya tampak: memiliki spektrum elektromagnetik yang bisa dideteksi oleh mata manusia
Ultraviolet rays: the main source that emits ultraviolet rays is the sun.	Sinar ultraviolet: sumber utama yang memancarkan sinar ultraviolet adalah matahari.
X-rays: used in medicine to view organs in the body such as bones	Sinar X: digunakan dalam bidang kedokteran untuk melihat organ dalam tubuh seperti tulang
Gamma rays: have the highest frequency and the greatest penetration. One of the uses of gamma rays is to sterilize medical equipment.	Sinar gamma: memiliki frekuensi paling tinggi dan daya tembus paling besar. Salah satu penggunaan sinar gamma untuk mensterilkan peralatan medis.
Einstein's theory of relativity refers to an inertial frame of reference, which is a frame of reference that moves at a constant (constant) speed relative to other frames of reference	Teori relativitas Einstein merujuk pada kerangka acuan inersial yaitu kerangka acuan yang bergerak relatif pada kecepatan konstan (tetap) terhadap kerangka acuan lainnya
The laws of physics take the same form in all inertial terms of reference.	Hukum-hukum fisika memiliki bentuk yang sama pada semua kerangka acuan inersial.
Light traveling in a vacuum at a speed of c = 3 x 108 m / s is the same for all observers and does not depend on the motion of the light source or the speed of the observer.	Cahaya yang merambat di ruang hampa dengan kecepatan c = 3 x 108 m/s adalah sama untuk semua pengamat dan tidak bergantung pada gerak sumber cahaya maupun kecepatan pengamat.
The first postulate is based on the absence of a general frame of reference that is absolutely at rest, so it cannot be determined which is at rest and which is in motion.	Postulat pertama didasarkan pada tidak adanya kerangka acuan umum yang diam mutlak, sehingga tidak dapat ditentukan mana yang dalam keadaan diam dan mana yang dalam keadaan bergerak
someone with the initials A is on the plane and someone with the initials B is on the surface of the earth	seseorang berinisial A berada di dalam pesawat dan seseorang berinisial B berada di permukaan bumi
From point of view A, the plane is stationary at a place and the surface of the earth is moving	Dari sudut pandang A, pesawat diam pada suatu tempat dan permukaan bumi-lah yang bergerak
From B's point of view, the surface of the earth on which he stands is still and the plane with A inside is moving.	Dari sudut pandang B, permukaan bumi tempat dia berpijak yang tetap diam dan pesawat dengan berisi si A didalamnya yang bergerak.
The second postulate states that the speed of light c is constant, independent of the observer measuring from the inertia reference frame	Postulat kedua menyatakan bahwa kecepatan cahaya c konstan, tidak bergantung pengamat yang mengukur dari kerangka acuan inersia
The measurement scale must be compared to the speed of light and no speed is greater than the speed of light	Skala pengukuran harus dibandingkan dengan kecepatan cahaya dan tidak ada kecepatan yang lebih besar dari kecepatan cahaya
Geographically, the north pole of the earth's magnet is in the south of the earth and the south pole of the earth's magnet is in the north of the earth	Secara geografis, kutub utara magnet bumi berada di selatan bumi dan kutub selatan magnet bumi berada di utara bumi
The earth's magnetic theory was first coined by William Gilbert. In theory, it is explained that the earth is magnetic because the earth's core is filled with loadstone or rocks that contain magnetic.	Teori magnet bumi pertama kali dicetuskan oleh William Gilbert. Pada teorinya dijelaskan kalau bumi bersifat magnet karena inti bumi dipenuhi dengan loadstone atau batuan yang mengandung magnetik.
In his experiments, he realized that the earth's magnet loses its magnetic ability when exposed to high temperatures.	Pada eksperimennya, dia menyadari kalau magnet bumi kehilangan kemampuan magnetiknya ketika terkena suhu yang tinggi.
Since the magnetic force often produces circular motions, he began to attribute this magnetic phenomenon to the rotation of the earth.	Karena kekuatan magnet sering menghasilkan gerakan melingkar, maka dia mulai menghubungkan fenomena magnet tersebut dengan rotasi bumi.
The dynamo theory which also explains the Earth's magnetism. In this theory, the liquid outer core contains an electric current.	Teori dinamo yang juga menjelaskan tentang kemagnetan bumi Pada teori ini, inti luar bumi yang bersifat cair mengandung arus listrik.
The structure of the earth is composed of several layers, namely the earth's core, the earth's mantle, and the earth's crust. The earth's core is divided into two, namely the inner core which is solid and the outer core which is liquid	Struktur bumi tersusun dari beberapa lapisan, yaitu inti bumi, mantel bumi, dan kerak bumi. Inti bumi terbagi menjadi dua, yaitu inti dalam yang bersifat padat dan inti luar yang bersifat cair
When the earth rotates, electrically charged particles in the liquid outer core of the earth also move and produce a magnetic field	Ketika bumi berotasi, partikel bermuatan listrik dalam cairan inti luar bumi ikut bergerak dan menghasilkan medan magnet
Because the earth is magnetic, there is an attractive force between the earth's magnet and the compass needle, as a result the compass always shows north and south.	Karena bumi bersifat magnetik, maka timbul gaya tarik menarik antara magnet bumi dengan jarum kompas, akibatnya kompas selalu menunjukan arah utara dan selatan.
The declination angle is the angle formed by the north pole of the compass needle in the direction of magnetic north / geographic south.	Sudut deklinasi adalah sudut yang dibentuk oleh kutub utara jarum kompas dengan arah utara magnet/selatan geografis.
The declination angle will be positive if the north pole of the compass deviates to the east and negative if the north pole of the compass deviates to the west	Sudut deklinasi akan bernilai positif jika kutub utara kompas menyimpang ke timur dan bernilai negatif jika kutub utara kompas menyimpang ke barat
For example, an object that is above the north pole has a declination angle of + 90 °, whereas if the object is above the south pole, the declination angle is -90 °	Misalnya, suatu objek yang berada di atas kutub utara memiliki sudut deklinasi +90°, sedangkan jika objek berada di atas kutub selatan maka sudut deklinasinya -90°
In addition to the declination angle, it turns out that there are other compass needle deviations	Selain terdapat sudut deklinasi, ternyata ada juga penyimpangan jarum kompas lainnya
The direction of the lines of the earth's magnetic field is not parallel to the earth's surface (horizontal plane)	Arah garis gaya medan magnet bumi tidak sejajar dengan permukaan bumi (bidang horizontal)
The position of the compass needle is slightly tilted at a certain angle. This angle is called the angle of inclination	Posisi jarum kompas ternyata agak miring pada sudut tertentu. Sudut itu dinamakan sudut inklinasi
The inclination angle is the angle formed between the tip of the compass needle and the horizontal direction of the earth's surface.	Sudut inklinasi adalah sudut yang dibentuk antara ujung jarum kompas dengan arah horizontal permukaan bumi.
The inclination angle is positive, if the north pole of the compass needle is above the horizontal line and negative if the north pole of the compass needle is below the horizontal line	Sudut inklinasi bernilai positif, jika kutub utara jarum kompas berada di sebelah atas garis mendatar dan bernilai negatif jika kutub utara jarum kompas berada di bawah garis mendatar
an object that is at the north pole has a declination angle of -90 °, whereas if the object is at the south pole, the declination angle is + 90 °.	suatu objek yang berada di kutub utara memiliki sudut deklinasi -90°, sedangkan jika objek berada di kutub selatan maka sudut deklinasinya +90°.
The compass needle always points to the north and south because of the attractive force between the compass needle and the earth's magnet	Jarum kompas selalu menunjuk ke arah utara dan selatan adalah karena adanya gaya tarik menarik antara jarum kompas dengan magnet bumi
Some time later when there was a ship that came close he always asked about his son	Beberapa waktu kemudian ketika ada kapal yang datang merapat ia selalu menanyakan kabar tentang anaknya
But every time he asked the crew or the skipper never got an answer	Namun setiap ia bertanya pada awak kapal atau nahkoda tidak pernah mendapatkan jawaban
"Have you seen my son, Malin? Is he okay? When did he come home?" he asked.	“Apakah kalian melihat anakku, Malin? Apakah dia baik-baik saja? Kapan ia pulang?” tanyanya
Malin never left any items or messages to her mother.	Malin tak pernah menitipkan barang atau pesan apapun kepada ibunya
For years there was no word, Mande Rubayah got word Malin was married to a noble princess	Bertahun-tahun tak ada kabar, Mande Rubayah mendapat kabar Malin telah menikah dengan putri bangsawan
For years Mande Rubayah kept asking questions but there was never an answer until his body got older	Bertahun-tahun Mande Rubayah terus bertanya namun tak pernah ada jawaban hingga tubuhnya semakin tua
The cellphone box is black, rectangular, and light yellow	kotak handphone itu berwarna hitam, berbentuk persegi panjang ,dan kuning muda
Excessive use of plastic can damage nature because plastic is difficult to destroy	penggunaan plastik yang berlebihan dapat merusak alam karena plastik sulit di hancurkan
litter that is dumped carelessly, especially plastic, can cause soil pollution	sampah yang dibuang sembarangan terutama plastik dapat menjadi penyebab pencemaran tanah
plastic that is not biodegradable then becomes toxic to living things around it, including humans	plastik yang tidak terurai ini kemudian menjadi racun bagi makhluk hidup di sekitarnya, termasuk manusia
Apart from plastic waste, pollutants are also one of the causes of pollution	Selain sampah plastik, polutan juga menjadi salah satu penyebab pencemaran
pollutants include waste including plastic bottles and bags, debris / debris from cement or bricks,	polutan antara lain sampah termasuk botol dan kantong plastik, debris/puing reruntuhan semen atau batu bata,
The causes of soil pollution can be divided into 5 based on the type of pollutant	penyebab pencemaran tanah dapat dibagi menjadi 5 berdasarkan tipe polutannya
Types of soil pollutants consist of bio-pollutants, agricultural activities, radioactive, urban waste, and industrial waste	Tipe polutan tanah terdiri dari bio-polutan, aktivitas pertanian, radioaktif, limbah urban, dan limbah buangan industri
Bio-pollutants are also known as pollutants derived from biological agents.	Bio-polutan disebut juga dengan polutan yang berasal dari agen-agen biologi.
These biological agents can usually act as compost for plants in the soil	Agen-agen biologi ini biasanya dapat berperan sebagai pupuk kompos bagi tanaman di dalam tanah
This type of pollutant comes from the excretion of humans, birds and other animals.	Jenis polutan ini berasal dari hasil ekskresi manusia, burung, dan hewan-hewan lainnya.
Agriculture and plantations usually use several chemicals to support crop yields	Pertanian maupun perkebunan biasanya menggunakan beberapa bahan kimia untuk menunjang hasil panen
These chemicals include pesticides, chemical fertilizers, herbicides, lime, compost, and so on	Bahan kimia tersebut di antaranya pestisida, pupuk kimia, herbisida, zat kapur, kompos, dan lain sebagainya
Excessive use of chemicals has the potential to pollute the soil and be harmful to human health.	Penggunaan bahan kimia yang berlebihan berpotensi mencemari tanah dan berbahaya bagi kesehatan manusia.
Radioactive substances resulting from human activities such as nitrogen, uranium, thorium, uranium, and others	Substansi radioaktif yang dihasilkan dari aktivitas manusia seperti nitrogen, uranium, thorium, uranium, dan lain-lain
Radioactive substances can clog the soil and have toxic effects on living things around them	Zat radioaktif dapat menyumbat tanah dan memberikan efek toksik bagi makhluk hidup di sekitarnya
Urban Waste This type of pollutant is generated from households and as a result of human activities in cities	Limbah Urban Jenis polutan ini dihasilkan dari rumah tangga dan sebagai hasil aktivitas manusia di perkotaan
Urban pollutants include plastic waste, domestic and commercial waste, and other waste materials	Polutan urban antara lain sampah plastik, limbah domestik maupun komersial, dan materi-materi buangan lainnya
Large-scale industries, such as mining and production plants, can cause long-term damage to land	Industri skala besar, seperti pertambangan dan pabrik produksi, dapat menyebabkan kerusakan tanah dalam jangka panjang
Large-scale industrial waste includes metals, such as lead (Pb), mercury (Hg), arsenic (As), nickel (Ni), and so on.	 Limbah industri skala besar di antaranya berupa logam, seperti timbal (Pb), merkuri (Hg), arsenik (As), nikel (Ni), dan sebagainya.
The Lapindo mud case is soil pollution caused by hot mudflow in Sidoarjo Regency	Kasus lumpur lapindo merupakan pencemaran tanah yang disebabkan oleh semburan lumpur panas di Kabupaten Sidoarjo
The hot mudflow occurred due to drilling activities in an exploration well owned by Lapindo Brantas Inc	Semburan lumpur panas tersebut muncul karena aktivitas pengeboran di sumur eksplorasi milik Lapindo Brantas Inc
Soil pollution cannot be underestimated because it has a dangerous impact.	pencemaran tanah tidak bisa dipandang sebelah mata karena menimbulkan dampak yang berbahaya.
The impact of soil pollution has a direct effect on living things and can damage environmental ecosystems.	Dampak pencemaran tanah berpengaruh secara langsung ke makhluk hidup dan dapat merusak eksosistem lingkungan.
Soil pollution has a dangerous impact on living things, from a health perspective to the environment.	Pencemaran tanah memiliki dampak yang berbahaya bagi makhluk hidup, mulai dari segi kesehatan hingga lingkungan.
The toxins released by pollutants in the soil can interact with ecosystems, either directly or indirectly.	Toksin yang dilepaskan oleh polutan di tanah dapat berinteraksi dengan ekosistem, baik secara langsung maupun tidak langsung.
Soil pollution causes a variety of health problems in humans themselves	Pencemaran tanah menimbulkan berbagai macam masalah kesehatan pada manusia itu sendiri
Cancer - Most soil pollutants contain carcinogens that can cause cancer, such as heavy metals	Kanker – Kebanyakan polutan tanah mengandung zat karsinogenik yang dapat menyebabkan kanker, seperti logam berat
Organ Damage - It is also caused by harmful soil pollutants.	Kerusakan Organ – Hal ini juga disebabkan oleh zat polutan tanah yang berbahaya.
Bioaccumulation - Bioaccumulation can occur when humans eat meat / vegetables that have been exposed to soil pollutants	Bioakumulasi – Bioakumulasi dapat terjadi apabila manusia memakan daging/sayur yang telah terpapar polutan tanah
The effect of soil pollution on the environment can damage the ecosystem. Some of the impacts caused by soil pollution	Efek pencemaran tanah terhadap lingkungan dapat merusakan ekosistem. Beberapa dampak yang disebabkan oleh pencemaran tanah
Loss of Biodiversity - Exposure to harmful pollutants can kill a number of plants or animals	Hilangnya Keanekaragaman Hayati – Paparan polutan yang berbahaya dapat mematikan sejumlah jenis tanaman atau hewan
Reducing Soil Fertility - Loss of soil biota or microflora can cause soil to become infertile.	Menurunkan Kesuburan Tanah – Hilangnya biota-biota atau mikroflora tanah dapat menyebabkan tanah menjadi tidak subu
Changes in Soil Structure - The soil structure undergoes changes with pollutants that kill important components in the soil.	Perubahan Struktur Tanah – Struktur tanah mengalami perubahan terdapat polutan yang mematikan komponen penting dalam tanah.
Agricultural activities such as over planting and uprooting of grass can result in flooding and soil erosion.	Aktivitas pertanian seperti menanam dan pencabutan rumput yang berlebihan dapat mengakibatkan banjir dan erosi tanah.
The Waste Footprint that we produce can be in the form of plastic waste, decomposing materials, dirt, etc.	Waste Footprint” yang kita hasilkan dapat berupa sampah plastik, materi yang sulut terurai, kotoran, dsb.
We can reduce “Waste Footprint” by doing 3Rs, namely Reuse, Reduce, and Recycle.	Kita dapat mengurangi “Waste Footprint” dengan cara melakukan 3R yaitu Reuse, Reduce, dan Recycle.
Soil washing aims to remove contaminants in the soil	Pencucian tanah bertujuan untuk menghilangkan kontaminan yang ada di dalam tanah
This management method uses water to clean the soil and separate contaminated soil	Cara pengelolaan ini menggunakan air untuk membersihkan tanah dan memisahkan tanah yang terkontaminasi
This management method uses microorganisms to reduce contaminants and restore soil fertility	Metode pengelolaan ini menggunakan mikroorganisme untuk mengurangi kontaminan dan mengembalikan kesuburan tanah
However, bioremediation also still requires the appropriate temperature, nutrients, and oxygen in the soil.	Namun, bioremediasi juga tetap membutuhkan temperatur yang sesuai, nutrisi, dan oksigen di dalam tanah.
Human activities can never be separated from environmental pollution.	Aktivitas manusia memang tidak pernah lepas dari adanya pencemaran lingkungan.
Indonesia is also in the top 3 of continental plate collisions. The north is Eurasia, the south is Indo-Australia, and the east is the Pacific.	indonesia juga berada di atas 3 tumbukan lempeng benua. Bagian utara ada Eurasia, selatan ada Indo-Australia, dan timur ada Pasifik
No wonder Indonesia is a country prone to earthquakes, tsunamis, and volcanic eruptions.	nggak heran kalau Indonesia menjadi negara yang rawan dengan gempa bumi, tsunami, dan juga letusan gurung berapi.
several volcanoes began to show their activity, such as Mount Merapi, and Anak Krakatau.	beberapa gunung berapi mulai menunjukkan aktivitasnya, seperti Gunung Merapi , dan Anak Krakatau.
The eruption of Mount Merapi had a rumbling sound which was then followed by an eruption as high as 6 km from the top of the mountain	Letusan Gunung Merapi ini sempat mengeluarkan suara gemuruh yang kemudian disusul erupsi setinggi 6 km dari puncak gunung
Mount Anak Krakatau ejects volcanic ash about 657 meters above sea level	Gunung Anak Krakatau menyemburkan abu vulkanik sekitar 657 meter di atas permukaan laut
every time a natural disaster occurs, there is a stage which is commonly referred to as the natural disaster management cycle	setiap terjadinya bencana alam, ada sebuah tahapan yang biasa disebut sebagai siklus penanggulangan bencana alam
These natural disasters occur not only once, but periodically or repeatedly.	bencana alam ini terjadi tidak hanya sekali, melainkan secara periodik atau berulang.
management of natural disasters must also be made carefully and gradually.	penanggulangan bencana alam pun harus dibuat dengan cermat, juga bertahap.
Starting from a disaster, post-disaster, pre-disaster, until then another disaster, and so on.	Mulai dari bencana, pascabencana, prabencana, sampai kemudian bencana lagi, begitu seterusnya.
Many things will happen in the aftermath of a disaster. People lost their loved ones, such as family, as well as relatives.	Banyak hal yang akan terjadi setelah terjadinya bencana. Orang-orang kehilangan yang mereka cintai, seperti keluarga, juga kerabat.
In the early stages after this disaster, the community will begin to focus on saving the victims who could be saved.	Pada tahap awal awal setelah bencana ini, masyarakat akan mulai berfokus menyelamatkan korban korban yang bisa diselamatkan.
He can't pull the ass out, no matter how hard he tries it	Dia tidak bisa menarik keledai tersebut keluar, tidak peduli seberapa keras ia mencobanya
Therefore, he decided to bury his donkey alive	Oleh karena itu, ia memutuskan untuk mengubur keledainya hidup-hidup
The ground begins to be deposited into the hole where the donkey is from above	Tanah mulai ditimbun ke lubang tempat keledai berada dari atas
Donkey who feels stricken by the ground, shakes his body to drop the ground on his body	Keledai yang merasa tertimpa tanah, menggoyangkan tubuhnya untuk menjatuhkan tanah di atas tubuhnya
And step on the ground. The next land is deposited back into the hole	Dan melangkah di atas tanah tersebut. Tanah berikutnya ditimbun kembali ke dalam lubang
The donkey shook his body again and climbed the ground	Keledai itu mengibaskan kembali tubuhnya dan menaiki tanah tersebut
The more land is stockpiled, the higher the land rises	Semakin tanah ditimbun, semakin tinggi tanah tersebut naik
When a man walks past a group of elephants, he suddenly stops	Ketika seorang pria berjalan melewati sekumpulan gajah, ia tiba-tiba berhenti
Rina and Dini are known as popular best friends in school	Rina dan Dini dikenal sebagai sahabat baik yang populer di sekolah
Although different classes, but they always spend time resting together	Meskipun berbeda kelas, tapi mereka selalu menghabiskan waktu istirahat bersama
No one doubts the close friendship between them	Tidak ada yang meragukan eratnya persahabatan diantara mereka
Although different characters, still does not hinder their closeness as friends	Meski berbeda karakter, tetap tidak menghalangi kedekatan mereka sebagai sahabat
Rina is a quiet schoolgirl who wouldn't be popular if she wasn't with her early	Rina merupakan seorang siswi pendiam yang tidak akan populer jika tidak bersama dini
While early tends to be like a bully who likes to show off his goods	Sedangkan dini cenderung seperti seorang pembual yang hobi memamerkan barangnya
One day at a prize draw, rina was chosen as the winner	Suatu hari pada sebuah acara pengundian hadiah, rina terpilih menjadi pemenang
He came together early, where the winners were allowed to choose their own prizes	Ia datang bersama dini, disana para pemenang diperbolehkan untuk memilih hadiah sendiri
Of the five winners selected, rina got a fourth turn to take the prize	Dari lima pemenang terpilih, rina mendapat giliran keempat untuk mengambil hadiah
Rina sees the winner who will take the prize afterwards, namely a mother	Rina melihat pemenang yang akan mengambil hadiah setelahnya, yaitu seorang ibu
A mother dressed in shabby clothes carrying her four young children	Seorang ibu berpakaian lusuh dengan membawa keempat anaknya yang masih kecil
The next day early told his friends about rina's stupidity	Keesokan harinya dini bercerita kepada teman-temannya tentang kebodohan rina
To prove it, it's early to call rina in front of her classmates	Untuk membuktikannya, dini memanggil rina ke hadapan teman-teman kelasnya
Until one day when early showing off his stupidity rina to one of the older brothers	Hingga suatu hari ketika dini memamerkan kebodohannya rina pada salah seorang kakak kelas
Again Rina chooses money with the lowest nominal, Everyone laughs	Lagi-lagi Rina memilih uang dengan nominal terendah, Semua orang tertawa
except Rifki.He was stunned to observe who was actually fooling who	kecuali Rifki. Ia tertegun mengamati siapa sebenarnya yang sedang membodohi siapa
Everyone was silent to hear the explanation from Kak Rifki.Instantly they felt they had done something stupid	Semua orang terdiam mendengar penjelasan dari Kak Rifki. Seketika mereka merasa telah melakukan hal bodoh
Meanwhile, Rina smiles at Kak Rifki who turned to laugh at Dini and her friends	Sedangkan Rina tersenyum memandang Kak Rifki yang berbalik menertawakan Dini dan teman-temannya
In the end, for Rina a good friend there is always an additional income	Pada akhirnya, bagi Rina teman yang baik itu selalu ada memberikan tambahan penghasilan
But it's okay, every deed must have a payoff and Dini's deeds are paid with money and shame	Tapi tidak apa-apa, setiap perbuatan pasti ada bayarannya dan perbuatan Dini dibayar dengan uang serta rasa malu
Ihsan is a student majoring in Informatics Engineering at one of the Universities	Ihsan adalah seorang mahasiswa jurusan Teknik Informatika di salah satu Perguruan Tinggi
One day, he told me about his life problems.	Suatu hari, dia bercerita kepadaku tentang masalah hidupnya
He thinks that other people always look happy and happy regardless of the problems experienced in his life	Dia berpikir kalau orang lain selalu terlihat senang dan bahagia terlepas dari masalah yang dialami dalam hidupnya
They look like people who don't have a burden on their shoulders.	Mereka terlihat seperti orang-orang yang tak memiliki beban di pundaknya
But strangely, Andi doesn't feel too fond when he sees his friend smiling happily	Namun anehnya, Andi merasa tidak terlalu suka saat melihat temannya tersenyum bahagia
Haikal, how strange I always feel that other people's lives are always fine	Haikal, kok aku aneh ya selalu merasa bahwa kehidupan orang lain selalu baik-baik aja
it even looks like I don't have a problem, it's so different from my life.	Bahkan kelihatan seperti tidak punya masalah, beda banget sama kehidupan aku
my life that feels like I have a lot of burdens and I also feel can not be happy	kehidupan aku yang rasanya kayak punya banyak beban terus aku juga merasa tidak bisa bahagia
At that very moment I told Andi that everyone has a problem borne on his shoulders	Pada waktu itu juga aku mengatakan kepada Andi bahwa setiap orang memiliki permasalahan ditanggung di pundaknya
Of course, each of the burdens of life experienced by each person must be different	Tentunya masing-masing beban hidup yang dialami setiap orang pasti berbeda-beda
The first negative impact caused by global warming is changes in temperature	Dampak negatif pertama yang diakibatkan oleh pemanasan global adalah perubahan temperatur
the change in temperature is the temperature that increases due to the heat trapped in the earth	perubahan temperaturnya adalah suhu yang semakin meningkat karena adanya panas yang terperangkap di dalam bumi
because the temperature is increasing day by day, the ice in the north and south poles also melts	karena suhunya semakin meningkat dari hari ke hari, es yang berada di kutub utara dan kutub selatan juga ikut mencair
The impact of global warming is the destruction of marine life due to changing temperatures in the marine environment	Dampak pemanasan global adalah rusaknya biota laut karena berubahnya suhu di lingkungan laut
When sea temperatures increase, the physical condition of coral reefs is also affected, coral reefs will experience bleaching	Ketika suhu laut meningkat, kondisi fisik terumbu karang ikut terpengaruh, terumbu karang akan mengalami pemutihan
Bleaching causes coral reefs to be susceptible to disease, which can lead to large numbers of deaths	Pemutihan tersebut akan menyebabkan terumbu karang rentan terserang penyakit sehingga bisa menyebabkan kematian dalam jumlah besar
Global warming can cause land dryness. If the land dries up, the nutrients needed by plants are also not optimal	Pemanasan global bisa menyebabkan kekeringan lahan. Jika lahannya mengering, nutrisi yang dibutuhkan oleh tumbuhan juga tidak maksimal
the phenomenon of global climate change which causes an increase in the earth's air temperature which from time to time has decreased	fenomena perubahan iklim global yang menyebabkan adanya peningkatan suhu udara bumi yang dari waktu-ke waktu mengalami penurunan
Climate change is caused by an increase in the concentration of greenhouse gases or also known as GHG in the atmosphere	Perubahan iklim disebabkan oleh peningkatan konsentrasi gas rumah kaca atau disebut juga GRK di atmosfer
because this gas longwave radiation that is hot trapped, as a result the earth's atmosphere is getting warmer.	karena gas ini radiasi gelombang panjang yang panas tertahan, akibatnya atmosfer bumi semakin memanas.
Human activities coupled with advances in industrial technology are accelerating climate change	Aktivitas manusia dibarengi dengan kemajuan teknologi industri mempercepat terjadinya perubahan iklim
waste, fumes from transportation and fossil fuel industry to animal and plant waste that accumulate can produce methane gas	Limbah, asap dari transportasi dan industri berbahan bakar fosil hingga kotoran hewan dan tumbuhan yang menumpuk dapat mengahasilkan gas metana
Increasing temperature plus increasing population in the world will increase energy demand	Meningkatnya suhu ditambah bertambahnya penduduk di dunia akan meningkatkan permintaan energi
The energy used will produce emissions that cause climate change.	Energi yang digunakan akan menghasilkan emisi yang menyebabkan perubahan iklim.
Air pollution which is very dangerous for the body can result in lowering the function of the human lungs	Polusi udara yang sangat berbahaya bagi tubuh dapat mengakibatkan menurunkan fungsi paru-paru manusia
In big cities, such as New York City, United States, cases of asthma have increased by as much as 10%.	Di kota besar, seperti New York City, Amerika Serikat, kasus asma meningkat sebanyak 10%.
Climate change triggers more extreme weather which results in disasters. For example, high intensity rain causes flooding.	Perubahan iklim memicu lebih banyak cuaca ekstrem yang menghasilkan bencana. Seperti, hujan dalam intensitas tinggi menyebabkan banjir.
love our earth by using environmentally friendly products, reduce the use of goods made of plastic	Cintai bumi kita dengan menggunakan produk yang ramah lingkungan, kurangi penggunaan barang yang terbuat dari plastik
The positive impact of social change is the emergence of new values and norms that are more in line with the demands of the times.	Dampak positif yang dari perubahan sosial adalah munculnya nilai dan norma baru yang lebih sesuai dengan tuntutan perkembangan zaman.
the second positive is the development of new social institutions, which are the application of structural differentiation	positif yang kedua adalah berkembangnya lembaga-lembaga sosial baru, yang merupakan penerapan dari diferensiasi struktural
transfer of early childhood education functions. Initially, the function of early childhood education is the responsibility of each family	pengalihan fungsi pendidikan usia dini. Fungsi pendidikan usia dini pada awalnya merupakan tanggung jawab masing-masing keluarga
The third positive impact is the rapid development of technology. Technology is one of the important factors in everyday life today	Dampak positif yang ketiga adalah pesatnya perkembangan teknologi. Teknologi merupakan salah satu faktor penting dalam kehidupan sehari-hari saat ini
Through technology, people can not only access information, but also provide information to one another.	Melalui teknologi, masyarakat tidak hanya bisa mengakses informasi, tetapi juga bisa saling memberikan informasi. 
social disorganization is a process of weakening values and norms in a society as a result of change	disorganisasi sosial merupakan proses melemahnya nilai dan norma dalam suatu masyarakat akibat terjadinya perubahan
In the current era of social media, people tend to turn to individualistic attitudes and pay less attention to the surrounding social environment	di era sosial media saat ini, masyarakat cenderung beralih kepada sikap individualistis dan kurang memperhatikan lingkungan sosial sekitar
The second negative impact is Cultural Shock.	Dampak negatif yang kedua adalah Cultural Shock atau guncangan budaya.
What is meant by cultural shock is a condition when people experience shock because they are not ready to accept change	Yang dimaksud dengan cultural shock adalah kondisi ketika masyarakat mengalami kaget karena belum siap menerima perubahan
The changes referred to here are changes that are caused by the presence of elements of a foreign culture that are different from their own culture	Perubahan yang dimaksud di sini adalah perubahan yang disebabkan akibat adanya unsur-unsur kebudayaan asing yang berbeda dengan kebudayaan sendiri
The worst impact of cultural shock is being left behind and it can cause social problems.	Dampak terburuk dari cultural shock adalah ketertinggalan kondisi dan bisa menyebabkan terjadinya masalah sosial. 
Cultural Lag or cultural gap is a mismatch between cultural elements due to cultural changes and shifts	Cultural Lag atau kesenjangan budaya merupakan ketidaksesuaian antara unsur-unsur kebudayaan akibat terjadinya perubahan serta pergeseran kebudayaan
Cultural lag can also occur if there is a difference in the level of progress between various regions in a culture.	Cultural lag juga dapat terjadi jika terjadinya perbedaan taraf kemajuan antara berbagai daerah dalam suatu kebudayaan.
Examples of cultural lag include the existence of a special bus which is actually intended to solve congestion problems in the capital, but it actually adds to congestion.	Contoh cultural lag antara lain keberadaan bus khusus yang sebenarnya ditujukan untuk mengurai masalah kemacetan di ibukota, namun justru menambah kemacetan.
Social symptoms can be a sign that there are values and norms of society that are out of date	Gejala sosial bisa menjadi penanda bahwa ada nilai dan norma masyarakat yang sudah ketinggalan zaman
So that the emergence of social symptoms is expected to bring up new values and norms in accordance with the times.	Sehingga munculnya gejala sosial diharapkan dapat memunculkan nilai dan norma baru yang sesuai dengan perkembangan zaman.
The times in society will increase awareness that men and women have the same human rights as human beings	Perkembangan zaman di masyarakat akan meningkatkan kesadaran bahwa laki-laki dan perempuan memiliki hak asasi yang sama sebagai manusia
Social phenomenon is an event that occurs in society concerning social and moral values	Gejala sosial merupakan suatu peristiwa yang terjadi di masyarakat yang menyangkut nilai-nilai sosial dan moral
Social symptoms can create friction in society and can trigger social change	Gejala sosial bisa menciptakan gesekan di masyarakat dan dapat memicu terjadinya perubahan sosial
This is clearly a good sign because with gender equality, there will be no more inequality or judgment from the environment on a gender.	Ini jelas merupakan pertanda yang baik karena dengan adanya kesetaraan gender, tidak ada lagi ketimpangan atau judgement dari lingkungan terhadap suatu gender
This structural differentiation refers to the development of new social institutions.	Diferensiasi struktural ini mengacu kepada berkembangnya lembaga-lembaga sosial baru.
Various kinds of needs in an increasingly complex society require new platforms and institutions to meet these needs	Berbagai macam kebutuhan di masyarakat yang semakin kompleks membutuhkan wadah dan lembaga baru untuk memenuhi kebutuhan tersebut
Successfully resolved social symptoms will lead to an understanding that education is important	Gejala sosial yang berhasil diatasi akan membawa pemahaman bahwa pendidikan itu penting
As a result, the public will be more aware of education and strive to gain access to education, especially formal education, which is even better.	Akibatnya, masyarakat akan lebih aware terhadap pendidikan dan berusaha untuk mendapatkan akses pendidikan, khususnya pendidikan formal, yang lebih baik lagi.
Along with the increasing need for education, the emergence of various scientific studies related to social phenomena that have occurred has increasingly made people aware	Seiring dengan meningkatnya kebutuhan akan pendidikan, munculnya berbagai penelitian ilmiah terkait gejala sosial yang telah terjadi semakin menyadarkan masyarakat
When the community has received a good education, the productivity of the community will increase accordingly.	Ketika masyarakat sudah mendapatkan pendidikan yang baik, produktivitas masyarakat pun akan meningkat dengan sendirinya.
An educated society will generally recognize the importance of each individual's contribution to political practice	Masyarakat yang terdidik umumnya akan menyadari pentingnya kontribusi setiap individu dalam praktek politik
The social phenomenon teaches people the importance of coexistence and respect for diversity.	Gejala sosial memberi pelajaran pada masyarakat akan pentingnya hidup berdampingan dan menghormati keanekaragaman.
Although it does not appear directly, with the social symptoms that occur, norms and educational values	Meskipun tidak muncul secara langsung, dengan adanya gejala sosial yang terjadi, nilai norma dan pendidikan
The word "conflict" comes from the Latin "configure" which means to hit each other	Kata “konflik” berasal dari bahasa Latin “configure” yang artinya saling memukul
In the large dictionary, the language of conflict itself is defined as bickering, strife, or contradiction	Dalam kamus Besar Bahasa konflik sendiri didefinisikan sebagai percekcokkan, perselisihan, atau pertentangan
Sociologically, conflict is defined as a social process between two or more people who try to get rid of the other party	secara sosiologis, konflik diartikan sebagai suatu proses sosial antara dua orang atau lebih yang berusaha menyingkirkan pihak lain 
Conflict is a process that causes disorder in people's lives.	Konflik merupakan suatu proses yang menyebabkan ketidakteraturan dalam kehidupan masyarakat.
Conflict can also be defined as the existence of two or more things that are opposite, inconsistent, and contradictory	Konflik juga dapat didefinisikan sebagai adanya dua hal atau lebih yang berseberangan, tidak selaras, dan bertentangan
Aspects of life in society that are not yet clear or which have not been thoroughly analyzed can be clarified by the presence of conflict	Aspek-aspek kehidupan di masyarakat yang belum jelas atau masih belum selesai ditelaah dapat diperjelas dengan adanya konflik
conflict allows the readjustment of norms, social relations in society concerned with the needs of individuals or groups	konflik memungkinkan adanya penyesuaian kembali norma, hubungan-hubungan sosial dalam masyarakat yang bersangkutan dengan kebutuhan individu atau kelompok
The existence of conflict makes each individual or group involved must rely on themselves to win the conflict over other individuals or groups.	Adanya konflik membuat setiap individu atau kelompok yang terlibat harus mengandalkan diri sendiri untuk memenangkan konflik tersebut atas individu atau kelompok lain.
When there are social changes in society, conflict can help revive old norms as well as create new norms	Ketika ada perubahan-perubahan sosial di masyarakat, konflik dapat membantu menghidupkan kembali norma-norma lama maupun menciptakan norma-norma baru
Conflict can also serve as a tool to strike a balance between the forces that exist in the communities involved.	Konflik juga dapat berfungsi sebagai alat untuk mencapai keseimbangan antara kekuatan-kekuatan yang ada di dalam masyarakat yang terlibat.
When the parties involved are equally strong, conflict can create a new compromise	Ketika pihak yang terlibat sama-sama kuat, konflik pun dapat memunculkan sebuah kompromi baru
Changes in the personalities of the individuals involved, either leading to positive or negative things.	Berubahnya kepribadian para individu yang terlibat, baik yang mengarah pada hal-hal positif maupun negatif.
Indonesia is a country with a tropical climate. So, in a year, we can feel 2 seasons,	Indonesia merupakan negara dengan iklim tropis. Jadi, dalam setahun, kita bisa merasakan 2 musim,
selingkung means limited to one environment. Derived from the word "circle-circle" which means to limit the surroundings	Selingkung artinya terbatas pada satu lingkungan. Berasal dari kata “lingkung-melingkung” yang berarti memberi batas pada sekeliling
selingkung style is a writing style that is agreed upon in one particular environment. The environment here means the publisher or the media	gaya selingkung adalah gaya penulisan yang disepakati pada satu lingkungan tertentu. Lingkungan di sini maksudnya bisa penerbit atau media
Every media or publisher has its own style of environment. There are those who follow KBBI, some are not	Setiap media atau penerbit punya gaya selingkungnya masing-masing. Ada yang mengikuti KBBI, ada juga yang nggak
Climate is an average weather pattern that occurs for a relatively longer time and covers a large area	Iklim adalah pola cuaca rata-rata yang terjadi untuk waktu yang relatif lebih lama dan mencakup wilayah yang luas
weather is an air condition that occurs in a relatively narrow place with a relatively short time.	Cuaca itu adalah keadaan udara yang terjadi di suatu tempat yang relatif sempit dengan waktu yang relatif singkat.
Climate has a long time span and wide area, so it can be identified and categorized easily	Iklim memiliki rentang waktu yang lama dan wilayah yang luas, sehingga bisa dikenali dan dikelompokkan dengan mudah
Solar climate is a climate classification based on the sun's heat that the earth receives	Iklim Matahari merupakan klasifikasi iklim yang didasarkan oleh panas matahari yang diterima bumi
According to the climate of the sun, the climate on earth is divided into 4, namely tropical, subtropical, temperate, and cold	Menurut Iklim Matahari, iklim di bumi dibagi menjadi 4, yaitu tropis, subtropis, sedang, dan dingin
Koppen climate is a climate grouping based on average rainfall and temperature	Iklim Koppen merupakan pengelompokkan iklim berdasarkan pada rata-rata curah hujan dan temperatur
This climate classification is divided into 5 types, and each type uses a letter as its symbol.	Klasifikasi iklim ini dibagi menjadi 5 tipe, dan masing-masing tipe menggunakan huruf sebagai simbolnya.
Junghuhn climate is a climate classification based on the altitude and vegetation in a certain area	Iklim Junghuhn merupakan klasifikasi iklim berdasarkan ketinggian dan vegetasi di kawasan tertentu
The Schmidt-Ferguson climate is a climate classification based on rainfall. In this classification, climate is divided into 8 types	Iklim Schmidt-Ferguson merupakan klasifikasi iklim berdasarkan curah hujan. Pada klasifikasi ini, iklim dibagi menjadi 8 tipe
Oldeman's climate, which is a climate classification that uses rainfall as a reference	Iklim Oldeman, yaitu klasifikasi iklim yang menggunakan curah hujan juga sebagai acuannya
The difference with the Schmidt-Ferguson climate is the criteria for a wet month and how to calculate it	Perbedaannya dengan iklim Schmidt-Ferguson adalah pada kriteria bulan basah dan cara menghitungnya
In the Oldeman climate, to determine the type of climate you don't need to use a formula like the Schmidt-Ferguson climate	Pada iklim Oldeman, untuk menentukan tipe iklimnya kamu gak perlu menggunakan rumus seperti iklim Schmidt-Ferguson
Mushrooms fall into the category of fungi because mushrooms do not have chlorophyll, so they are unable to produce their own food	Jamur-jamuran masuk ke dalam kategori fungi karena jamur tidak mempunyai klorofil, sehingga tidak mampu menghasilkan makanannya sendiri
The body structure of fungi is generally multicellular (multicellular). Even so, there are also groups of fungi that are unicellular in nature.	Struktur tubuh jamur pada umumnya bersifat multiseluler (bersel banyak). Meskipun begitu, ada juga kelompok jamur yang sifatnya uniseluler. 
other properties of fungi are eukaryotic (have a nuclear membrane) and heterotroph (cannot make their own food)	Sifat lain jamur adalah eukariotik (memiliki membran inti) dan heterotrof (tidak bisa membuat makanan sendiri)
Unable to make their own food, the fungus has to live by hitching a ride from its host	Karena tidak dapat membuat makanannya sendiri, jamur harus hidup dengan menumpang dari inangnya
There are several ways of living / symbiotic fungi, there are types of fungi that are symbiotic by means of saprophytes, parasites, and some are symbiotic to form lichenes.	Cara jamur hidup/bersimbiosis ada beberapa,  Ada jenis jamur yang bersimbiosis dengan cara saprofit, parasit, dan ada yang bersimbiosis membentuk lichenes.
There are other things that distinguish mushrooms from plants. If examined anatomically, both have differences in the constituents of the cell wall	Ada hal lain yang membedakan jamur dengan tumbuhan. Jika diteliti secara anatomis, keduanya mempunyai perbedaan di penyusun dinding sel
The cell wall in plants is made up of cellulose, while fungi are composed of chitin	Dinding sel pada tumbuhan terdiri dari selulosa, sementara jamur disusun oleh kitin
fungus grows in a humid place and has a lot of organic substances. mushrooms do not really like exposure to direct sunlight	Jamur tumbuh ditempat yang lembab serta memiliki banyak zat organik.  jamur tidak terlalu suka terpapar cahaya matahari langsung
Fungi belonging to the multicellular category do not have elongated thread-like cells called hyphae	Jamur-jamur yang termasuk kategori multiseluler tidak mempunyai sel-sel memanjang menyerupai benang yang disebut dengan hifa
hyphae in certain fungi, some of which are insulated on the hyphae of the fungus, called septa	Hifa di jamur tertentu, ada yang bersekat sekat pada hifa jamur disebut dengan septa
The characteristics of this fungal classification are hyphae that are not insulated and have several nuclei (coenositic), sexual and asexual reproduction, there are rhizoids.	Ciri-ciri dari klasifikasi jamur ini adalah hifa tidak bersekat dan mempunyai beberapa inti (koenositik), reproduksi seksual dan aseksual, terdapat rhizoid.
This group can reproduce both sexually and asexually. Example: Rhizopus stolonifer (growing on bread), Rhizophus oryzae (tempeh mushroom).	Kelompok ini dapat berkembang biak baik secara seksual maupun aseksual. Contoh: Rhizopus stolonifer (tumbuh di roti), Rhizophus oryzae (jamur tempe).
Ascomycota is a group of fungi whose hyphas are insulated, and each hyphae has one nucleus.	Ascomycota adalah kelompok fungi yang hifanya bersekat, dan di setiap sel hifanya berinti satu.
This group can reproduce both sexually and asexually. Example: Saccharomyces cerevisiae (yeast), Penicillium sp, and Aspergillus sp.	Kelompok ini dapat berkembang biak baik secara seksual maupun aseksual. Contoh: Saccharomyces cerevisiae (ragi), Penicillium sp, dan Aspergillus sp.
Basidiomycota are fungi that live as saprophytes (living with a host in the form of dead living things) and parasites.	Basidiomycota adalah jamur yang hidupnya sebagai saprofit (tinggal dengan inang berupa makhluk hidup yang sudah mati) dan parasite
Deuteromycota is a group of fungi that reproduce asexually, their hyphas are insulated, and their lives stick to food scraps.	Deuteromycota merupakan kelompok jamur yang berkembang biak secara aseksual hifanya bersekat, dan hidupnya menempel di sisa-sisa makanan
However, there are certain types of this group that are parasitic. Example: Candida albicans (a fungus that causes an infectious disease in the vagina)	Tetapi, ada jenis tertentu dari kelompok ini yang sifatnya parasit. Contoh: Candida albicans (jamur yang menyebabkan penyakit infeksi pada vagina)
After recovering from his illness he became more and more unfortunate. They are mothers and children who love each other	Setelah sembuh dari sakitnya ia semakin disayang. Mereka adalah ibu dan anak yang saling menyayangi
As an adult, Malin begs to travel in order to change her and her mother's fate	Saat dewasa, Malin memohon untuk merantau agar dapat mengubah nasibnya dan ibunya
When Malin was an adult she asked her mother for permission to travel to the city	Saat Malin sudah dewasa ia meminta izin kepada ibunya untuk pergi merantau ke kota
because at that time there was a big ship docked at Air Manis Beach	karena saat itu sedang ada kapal besar merapat di Pantai Air Manis
"Don't Malin, I'm afraid something's going on with you in the country.Just stay here, stay with me,"	“Jangan Malin, ibu takut terjadi sesuatu denganmu di tanah rantau sana. Menetaplah saja di sini, temani ibu,”
"I'm calm, nothing's going to happen to me," Malin said, holding her mother's hand.	“Ibu tenanglah, tidak akan terjadi apa-apa denganku,” kata Malin sambil menggenggam tangan ibunya
"This is a chance ma'am, because not necessarily once a year there is a large ship docked on this beach.	“Ini kesempatan Bu, kerena belum tentu setahun sekali ada kapal besar merapat di pantai ini.
Mande Rubayah allowed Malin to wander, he also gave rice supplies to Malin	Mande Rubayah mengizinkan Malin untuk merantau, ia pun memberikan bekal nasi untuk Malin
"All right, I'll let you. Hurry back, I will always wait for you son," his mother said through tears.	“Baiklah, ibu izinkan. Cepatlah kembali, ibu akan selalu menunggumu Nak,” kata ibunya sambil menangis.
Although with a heavy heart mande Rubayah finally allowed Malin to leave	Meski dengan berat hati akhirnya Mande Rubayah mengizinkan Malin untuk pergi
Then Malin is provided with rice wrapped in banana leaves as much as seven packs	Kemudian Malin dibekali dengan nasi berbungkus daun pisang sebanyak tujuh bungkus
